border_size=1
usage=map

Xos, Xos, Xos, Xos, Xos, Xos, Xos, Xos, Xos, Xos, Xos, Xos, Xos, Xos, Xos, Xos, Xos, Xos, Xos, Xos, Xos, Xos, Xos, Xos, Xos, Xos, Xos, Xos, Xos, Xos, Xos, Xos, Xos, Xos, Xos, Xos, Xos, Xos, Xos, Xos, Xos, Xos, Xos, Xos, Xos, Xos
Xos, Xos, Xos, Xos, Urb^Yfro, Xos, Urb^Yfro, Urb^Yfro, Urb^Yfro, Urb^Yfro, Urb^Yfro, Urb^Yfro, Urb^Yfro, Xos, Xos, Xos, Xos, Xos, Rrc^Yfro, Xos, Xos, Xos, Rrc^Yfro, Xos, Xos, Xos, Xos, Xos, Rrc^Yfro, Rrc^Yfro, Rrc^Yfro, Xos, Xos^Yrug, Xos, Rrc^Yfro, Xos, Xos, Xos, Rrc^Yfra, Xos, Xos, Xos, Xos, Xos, Xos, Xos
Xos, Xos, Urb^Yfro, Urb^Yfro, Urb^Yfro, Urb^Yfro, Urb^Yfro, Urb^Yfro, Ai^Yfro, Ai^Yfro, Ai^Yfro, Urb^Yfro, Urb^Yfro, Urb^Yfro, Urb^Yfro, Xos, Rrc^Yfro, Rrc^Yfro, Rrc^Yfro, Rrc^Yfro, Rrc^Yfro, Rrc^Yfro, Rrc^Yfro, Rrc^Yfro, Rrc^Yfro, Rrc^Yfro, Rrc^Yfro, Rrc^Yfro, Rrc^Yfro, Rrc^Yfro, Rrc^Yfro, Rrc^Bryb, 2 Rrc^Yfro, Rrc^Bryb, Rrc^Yfro, Rrc^Yfro, Rrc^Yfro, Rrc^Yfro, Rrc^Yfro, Rrc^Yfra, Rrc^Yfra, Rrc^Yfra, Rrc^Yfra, Xos, Xos, Xos
Xos, Xos, Urb^Yfro, Urb^Yfro, Urb^Yfro, Urb^Yfro, Ai^Yfro, Ai^Yfro, Ai^Yfro, Ai^Yfro, Ai^Yfro, Urb^Yfro, Urb^Yfro, Urb^Yfro, Urb^Yfro, Xos, Xos, Rrc^Yfro, Rrc^Yfro, Rrc^Yfro, Rrc^Yfro, Rrc^Yfro, Xos, Rrc^Yfro, Rrc^Yfro, Rrc^Yfro, Rrc^Yfro, Rrc^Yfro, Rrc^Yfro, Rrc^Yfro, Rrc^Yfro, Rrc^Yfro, Rrc^Yfro, Rrc^Yfro, Rrc^Yfro, Rrc^Yfro, Rrc^Yfro, Rrc^Yfro, Rrc^Yfro, Rrc^Yfro, Rrc^Yfro, Rrc^Yfra, Rrc^Yfra, Rrc^Yfra, Rrc^Yfra, Xos
Xos, Urb^Yfro, Urb^Yfro, Urb^Yfro, Ai^Yfro, Ai^Yfro, Ai^Yfro, Ai^Yfro, Ai^Yfro, Ai^Yfro, Ai^Yfro, Ai^Yfro, Urb^Yfro, Urb^Yfro, Urb^Yfro, Xos, Xos, Rrc^Yfro, Rrc^Yfro, Rrc^Yfro, Rrc^Yfro, Xos, Rrc^Yfro, Rrc^Yfro, Rrc^Yfro, Rrc^Yfro, Rrc^Yfro, Rrc^Yfro, Rrc^Yfro, Rrc^Yfro, Rrc^Yfro, Rrc^Yfro, Rrc^Yfro, Rrc^Yfro, Rrc^Yfro, Rrc^Yfro, Rrc^Yfro, Rrc^Yfro, Rrc^Yfro, Rrc^Yfro, Rrc^Yfro, Rrc^Yfra, Rrc^Yfra, Rrc^Yfra, Rrc^Yfra, Xos
Xos, Urb^Yfro, Urb^Yfro, Urb^Yfro, Urb^Yfro, Ai^Yfro, Ai^Yfro, Ai^Yfro, Ai^Yfro, Ai^Yfro, Ai^Yfro, Ai^Yfro, Urb^Yfro, Urb^Yfro, Urb^Yfro, Urb^Yfro, Xos, Rrc^Yfro, Rrc^Yfro, Rrc^Yfro, Rrc^Yfro, Rrc^Yfro, Rrc^Yfro, Rrc^Yfro, Rrc^Yfro, Rrc^Yfro, Rrc^Yfro, Rrc^Yfro, Rrc^Yfro, Rrc^Yfro, Rrc^Yfro, Rrc^Yfro, Rrc^Yfro, Rrc^Yfro, Rrc^Yfro, Rrc^Yfro, Rrc^Yfro, Rrc^Yfro, Rrc^Yfro, Rrc^Yfro, Rrc^Yfra, Rrc^Yfra, Rrc^Yfra, Rrc^Yfra, Rrc^Yfra, Xos
Xos, Urb^Yfro, Urb^Yfro, Urb^Yfro, Urb^Yfro, Urb^Yfro, Urb^Yfro, Ai^Yfro, Urb^Yfro, Ai^Yfro, Ai^Yfro, Ai^Yfro, Urb^Yfro, Urb^Yfro, Urb^Yfro, Urb^Yfro, Urb^Yfro, Urb^Yfro, Rrc^Yfro, Rrc^Yfro, Rrc^Yfro, Rrc^Yfro, Rrc^Yfro, Rrc^Yfro, Rrc^Yfro, Rrc^Yfro, Rrc^Yfro, Rrc^Yfro, Xos, Rrc^Yfro, Rrc^Yfro, Rrc^Yfro, Rrc^Yfro, Rrc^Yfro, Rrc^Yfro, Xos, Rrc^Yfro, Rrc^Yfro, Rrc^Yfro, Rrc^Yfro, Rrc^Yfra, Rrc^Yfra, Rrc^Yfra, Rrc^Yfra, Rrc^Yfra, Xos
Xos, Xos, Xos, Urb^Yfro, Xos, Urb^Yfro, Urb^Yfro, Urb^Yfro, Urb^Yfro, Urb^Yfro, Urb^Yfro, Urb^Yfro, Urb^Yfro, Urb^Yfro, Urb^Yfro, Urb^Yfro, Xos, Urb^Yfro, Rrc^Yfro, Rrc^Yfro, Rrc^Yfro, Rrc^Yfro, Rrc^Yfro, Rrc^Yfro, Rrc^Yfro, Rrc^Yfro, Rrc^Yfro, Rrc^Yfro, Xos, Rrc^Yfro, Rrc^Yfro, Rrc^Yfro, Rrc^Yfro, Rrc^Yfro, Rrc^Yfro, Xos, Rrc^Yfro, Rrc^Yfro, Rrc^Yfro, Rrc^Yfra, Rrc^Yfra, Rrc^Yfra, Rrc^Yfra, Rrc^Yfra, Xos, Xos
Xos, Xos, Xos, Xos, Xos, Xos, Xos, Urb^Yfro, Xos, Urb^Yfro, Urb^Yfro, Urb^Yfro, Urb^Yfro, Urb^Yfro, Urb^Yfro, Urb^Yfro, Urb^Yfro, Xos, Rrc^Yfro, Rrc^Yfro, Rrc^Yfro, Rrc^Yfro, Rrc^Yfro, Rrc^Yfro, Rrc^Yfro, Rrc^Yfro, Rrc^Yfro, Rrc^Yfro, Rrc^Yfro, Rrc^Yfro, Rrc^Yfro, Rrc^Yfro, Rrc^Yfro, Rrc^Yfro, Rrc^Yfro, Rrc^Yfro, Rrc^Yfro, Rrc^Yfro, Rrc^Yfra, Rrc^Yfra, Rrc^Yfra, Rrc^Yfra, Rrc^Yfra, Rrc^Yfra, Xos, Xos
Xos, Xos, Xos, Xos, Xos, Xos, Xos, Xos, Xos, Xos, Xos, Urb^Yfro, Urb^Yfro, Urb^Yfro, Urb^Yfro, Urb^Yfro, Urb^Yfro, Xos, Rrc^Yfro, Rrc^Yfro, Rrc^Yfro, Rrc^Yfro, Rrc^Yfro, Rrc^Yfro, Rrc^Yfro, Rrc^Yfro, Rrc^Yfro, Rrc^Yfro, Rrc^Yfro, Rrc^Yfro, Rrc^Yfro, Rrc^Yfro, Rrc^Yfro, Rrc^Yfro, Rrc^Yfro, Rrc^Yfro, Rrc^Yfra, Rrc^Yfra, Rrc^Yfra, Rrc^Yfra, Rrc^Yfra, Rrc^Yfra, Rrc^Yfra, Rrc^Yfra, Rrc^Yfra, Xos
Xos, Xos, Xos, Xos, Urb, Urb, Urb, Xos, Xos, Xos, Xos, Xos, Xos, Urb^Yfro, Urb^Yfro, Urb^Yfro, Urb^Yfro, Xos, Xos, Rrc^Yfro, Rrc^Yfro, Rrc^Yfro, Rrc^Yfro, Rrc^Yfro, Rrc^Yfro, Rrc^Yfro, Rrc^Yfro, Rrc^Yfro, Xos, Rrc^Yfro, Rrc^Yfro, Rrc^Yfro, Rrc^Yfro, Rrc^Yfro, Rrc^Yfro, Xos, Rrc^Yfra, Rrc^Yfra, Rrc^Yfra, Rrc^Yfra, Rrc^Yfra, Rrc^Yfra, Rrc^Yfra, Rrc^Yfra, Rrc^Yfra, Xos
Xos, Xos, Urb, Urb, Urb, Urb^Esd, Urb, Urb, Urb, Xos, Xos, Xos, Xos, Xos, Urb^Yfro, Urb^Yfro, Urb^Yfro, Urb^Yfro, Xos, Rrc^Yfro, Rrc^Yfro, Rrc^Yfro, Rrc^Yfro, Rrc^Yfro, Rrc^Yfro, Rrc^Yfro, Rrc^Yfro, Rrc^Yfro, Xos, Rrc^Yfro, Rrc^Yfro, Rrc^Yfro, Rrc^Yfro, Rrc^Yfro, Rrc^Yfro, Xos, Rrc^Yfra, Rrc^Yfra, Rrc^Yfra, Rrc^Yfra, Rrc^Yfra, Rrc^Yfra, Rrc^Yfra, Rrc^Yfra, Rrc^Yfra, Xos
Xos, Xos, Urb, Urb, Urb, Urb, Urb, Urb, Urb, Urb, Urb, Xos, Xos, Xos, Xos, Urb^Yfro, Urb^Yfro, Urb^Yfro, Xos, Rrc^Yfro, Xos, Rrc^Yfro, Rrc^Yfro, Rrc^Yfro, Rrc^Yfro, Rrc^Yfro, Rrc^Yfro, Rrc^Yfro, Rrc^Yfro, Rrc^Yfro, Rrc^Yfro, Rrc^Yfro, Rrc^Yfro, Rrc^Yfro, Rrc^Yfro, Rrc^Yfro, Rrc^Yfra, Rrc^Yfra, Rrc^Yfra, Rrc^Yfra, Rrc^Yfra, Rrc^Yfra, Rrc^Yfra, Rrc^Yfra, Rrc^Yfra, Xos
Xos, Xos, Urb, Urb, Urb, Xos, Xos, Urb, Urb, Urb, Urb, Urb, Urb, Xos, Xos, Xos, Xos, Xos, Xos, Xos, Xos, Xos, Xos, Xos, Xos, Rrc^Yfro, Xos, Rrc^Yfro, Rrc^Yfro, Rrc^Yfro, Rrc^Yfro, Rrc^Yfro, Rrc^Yfro, Rrc^Yfro, Rrc^Yfro, Rrc^Yfra, Rrc^Yfra, Rrc^Yfra, Rrc^Yfra, Rrc^Yfra, Rrc^Yfra, Rrc^Yfra, Rrc^Yfra, Rrc^Yfra, Xos, Xos
Xos, Xos, Xos, Xos, Urb, Urb, Urb, Xos, Xos, Urb, Urb, Urb, Xos, Urb, Rrc, Xos, Xos, Xos, Xos, Xos, Xos, Xos, Xos, Xos, Xos, Xos, Xos, Xos, Rrc^Yfro, Rrc^Yfro, Rrc^Yfro, Rrc^Yfro, Rrc^Yfro, Rrc^Yfro, Xos, Rrc^Yfra, Xos, Rrc^Yfra, Xos, Rrc^Yfra, Rrc^Yfra, Rrc^Yfra, Rrc^Yfra, Rrc^Yfra, Xos, Xos
Xos, Xos, Urb, Urb, Urb^Esd, Urb, Urb, Urb, Urb, Xos, Xos, Xos, Rrc, Rrc, Rrc, Rrc, Rrc^Yfra, Xos, Rrc^Yfro, Xos, Rrc^Yfro, Xos, Rrc^Yfro, Xos, Rrc^Yfro, Xos, Xos, Xos, Xos, Rrc^Yfro, Rrc^Yfro, Rrc^Yfro, Xos, Xos, Xos, Xos, Xos, Xos, Xos, Xos, Xos, Xos, Xos, Xos, Xos, Xos
Xos, Xos, Urb, Urb, Urb, Urb, Urb, Urb, Xos, Xos, Rrc, Rrc, Rrc^Yfra, Rrc, Rrc^Yfra, Rrc^Yfra, Rrc^Yfro, Rrc^Yfro, Rrc^Yfro, Rrc^Yfro, Rrc^Yfra, Rrc^Yfro, Rrc^Yfra, Rrc^Yfro, Rrc^Yfro, Rrc^Yfro, Rrc^Yfro, Rrc^Yfro, Rrc^Yfro, Rrc^Yfro, Rrc^Yfro, Rrc^Yfro, Rrc^Yfro, Rrc^Yfro, Rrc^Yfro, Rrc^Yfro, Rrc^Yfro, Rrc^Yfro, Rrc^Yfro, Rrc^Yfra, Rrc^Yfra, Xos, Rrc^Yfra, Xos, Xos, Xos
Xos, Xos, Xos, Urb, Urb, Urb, Xos, Xos, Rrc, Rrc, Rrc, Rrc, Rrc, Rrc^Yfra, Rrc^Yfra, Rrc^Yfra, Rrc^Yfra, Rrc^Yfra, Rrc^Yfra, Rrc^Yfra, Rrc^Esd, Rrc^Yfra, Rrc^Yfra, Rrc^Yfro, Rrc^Yfro, Rrc^Yfro, Rrc^Yfro, Rrc^Yfro, Rrc^Yfro, Rrc^Yfro, Rrc^Yfro, Rrc^Yfro, Rrc^Yfro, Rrc^Yfro, Rrc^Yfro, Rrc^Yfro, Rrc^Yfra, Rrc^Yfra, Xos, Rrc^Yfra, Rrc^Yfra, Rrc^Yfra, Rrc^Yfra, Rrc^Yfra, Xos, Xos
Xos, Xos, Xos, Xos, Xos, Xos, Rrc, Rrc, Rrc, Rrc, Rrc, Rrc, Rrc^Es, Rrc, Rrc^Yfra, Rrc^Yfra, Rrc^Yfra, Rrc^Yfra, Rrc, Rrc, Rrc, Rrc, Rrc^Yfra, Rrc^Yfra, Rrc^Yfra, Rrc^Yfro, Rrc^Yfro, Rrc^Yfro, Rrc^Yfro, Rrc^Yfro, Xos, Xos, Xos, Rrc^Yfro, Rrc^Yfro, Rrc^Yfro, Rrc^Yfro, Xos, Xos, Xos, Rrc^Yfra, Rrc^Yfra, Rrc^Yfra, Rrc^Yfra, Xos, Xos
Xos, Xos, Xos, Xos, Xos, Xos, Xos, Rrc, Xos, Rrc, Rrc, Rrc, Rrc, Rrc, Rrc, Rrc, Urb, Urb, Urb, Urb, Urb, Rrc, Rrc, Rrc, Rrc, Rrc^Yfra, Rrc^Yfra, Rrc^Yfro, Rrc^Yfra, Rrc^Yfro, Rrc^Yfra, Xos, Rrc^Yfra, Rrc^Yfro, Rrc^Yfra, Rrc^Yfra, Rrc^Yfra, Rrc^Yfro, Rrc^Yfro, Rrc^Yfra, Rrc^Yfro, Rrc^Yfra, Rrc^Yfra, Rrc^Yfra, Xos, Xos
Xos, Xos, Xos, Xos, Xos, Xos, Xos, Xos, Xos, Xos, Xos, Rrc, Xos, Rrc, Rrc, Rrc, Urb, Urb, Urb, Urb, Urb, Urb, Urb, Urb, Rrc, Rrc, Rrc^Yfra, Rrc^Yfra, Rrc^Yfra, Rrc^Yfra, Rrc, Rrc^Yfra, Rrc^Yfra, Rrc^Yfro, Rrc^Yfra, Rrc^Yfra, Rrc^Yfra, Rrc^Yfra, Rrc^Yfra, Rrc^Yfro, Rrc^Yfra, Rrc^Yfra, Rrc^Yfra, Rrc^Yfra, Xos, Xos
Ai, Xos, Xos, Xos, Ai, Xos, Xos, Xos, Xos, Xos, Xos, Xos, Xos, Rrc, Rrc, Urb, Urb, Urb, Wog, Urb, Wog, Urb, Urb, Urb, Urb, Rrc, Rrc, Rrc, Rrc, Rrc, Rrc, Rrc, Rrc^Yfra, Rrc^Yfra, Rrc^Yfra, Xos, Xos, Rrc^Yfra, Rrc^Yfra, Rrc^Yfra, Rrc^Yfra, Rrc^Yfra, Xos, Xos, Xos, Xos
Ai, Ai, Ai, Ai, Ai, Ai, Ai, Xos, Xos, Xos, Xos, Xos, Xos, Xos, Xos, Xos, Xos, Wog, Wog, Wog, Wog, Wog, Xos, Urb, Urb, Rrc, Xos, Rrc, Xos, Rrc, Xos, Xos, Xos, Xos, Xos, Xos, Xos, Xos, Xos, Xos, Xos, Xos, Xos, Xos, Xos, Xos
Ai, Ai, Ai, Ai, Ai, Ai, Ai, Ai, Ai, Ai, Ai, Xos, Xos, Xos, Xos, Xos, Xos, Wog, Wog, Wog, Rb, Wog, Xos, Xos, Xos, Xos, Xos, Xos, Xos, Xos, Xos, Xos, Xos, Xos, Xos, Xos, Xos, Xos, Xos, Xos, Xos, Xos, Xos, Xos, Xos, Xos
Ai, Ai, Ai, Ai, Ai, Ai, Ai, Ai, Ai, Ai, Ai, Ai, Ai, Xos, Xos, Xos, Ai, Ss, Ss, Aa, Aa, Ai, Ai, Xos, Xos, Xos, Xos, Ai, Ai, Ai, Ai, Ai, Ai, Ai, Ai, Ai, Ai, Xos, Xos, Xos, Xos, Xos, Xos, Xos, Ai, Xos
Ai, Ai, Ai, Ai, Ai, Ai, Ai, Ai, Ai, Ai, Ai, Ai, Ai, Ai, Ai, Ai, Ai, Ai, Ai, Ai, Ai, Aa, Ai, Xos, Xos, Xos, Ai, Ai, Ai, Ai, Ai, Ai, Ai, Ai, Ai, Ai, Ai, Ai, Ai, Xos, Xos, Xos, Ai, Ai, Ai, Ai
Ai, Ai, Ai, Ai, Ai, Ai, Ai, Ai, Ai, Ai, Ai, Ai, Ai, Ai, Ai, Ai, Ai, Ss, Ai, Ai, Ss, Ai, Ai, Ai, Ai, Ai, Ai, Ai, Ai, Ai, Ai, Ai, Ai, Ai, Ai, Ai, Ai, Ai, Ai, Ai, Ai, Ai, Ai, Ai, Ai, Ai
Ai, Ai, Ai, Ai, Ai, Ai, Ai, Ai, Ai, Ai, Ai, Ai, Ai, Ai, Ss, Ai, Ai, Ai, Ss, Ai, Ai, Ai, Ss, Ai, Ai, Ai, Ai, Ai, Ai, Ai, Ai, Ai, Ai, Ai, Ai, Ai, Ai, Ai, Ai, Ai, Ai, Ai, Ai, Ai, Ai, Ai
Aa, Ai, Ai, Ai, Ai, Ai, Ai, Ai, Ai, Ai, Ai, Ai, Ai, Ai, Ai, Ai, Ai, Ss, Ai, Ss, Ss, Ss, Ai, Ai, Aa, Aa, Aa, Ai, Ai, Ai, Ai, Ai, Ai, Ai, Ai, Ai, Ai, Ai, Ai, Ai, Ai, Ai, Ai, Ai, Ai, Ai
Aa, Aa, Aa, Ai, Ai, Ai, Ai, Ai, Ai, Ai, Ai, Wog, Wog, Wog, Ai, Ai, Ai, Ai, Aa, Ss, Ai, Ai, Ss, Aa^Fpa, Aa^Fpa, Aa^Vca, Aa, Ai, Ai, Ai, Ai, Ai, Ai, Ai, Ai, Ai, Ai, Ai, Ai, Ai, Ai, Ai, Ai, Ai, Ai, Ai
Ha, Aa, Aa, Aa, Aa, Ai, Ai, Ai, Ai, Ai, Ai^Bw/, Wog^Bw/, Ai, Wog, Ai, 1 Ai, Ai, Ai, Ss, Aa, Ai, Ai, Ai, Aa^Fpa, Aa, Aa, Ai, Ai, Ai, Ai, Ai, Ai, Ai, Ai, Ai, Ai, Ai, Ai, Ai, Ai, Ai, Ai, Ai, Ai, Ai, Ai
Aa^Fpa, Aa, Aa, Aa, Aa, Aa, Aa, Ai, Rb, Ai^Bw/, Ai, Ai, Ai, Ai, Ai, Ai, Ai, Ai, Ai, Ai, Ai, Ai, Ai, Aa, Ai, Ai, Ai, Ai, Ai, Ai, Ai, Ai, Ai, Ai, Ai, Ai, Ai, Ai, Ai, Ai, Ai, Ai, Ai, Ai, Aa, Aa
Aa^Fpa, Aa^Vca, Aa, Aa, Rb, Aa, Rb, Rb, Aa, Aa, Aa, Aa, Aa, Ai, Aa, Ai, Aa, Ai, Ai, Ai, Ai, Ai, Ai, Ai, Ai, Ai, Ai, Ai, Ai, Ai, Ai, Ai, Ai, Ai, Ai, Ai, Ai, Ai, Ai, Ai, Ai, Ai, Aa, Aa, Aa, Aa
Aa^Fpa, Aa^Fpa, Rb, Rb, Rb, Rb, Aa, Aa, Aa, Aa^Vca, Aa^Fpa, Aa, Aa^Fpa, Aa, Aa, Aa, Aa, Aa, Aa, Ai, Ai, Ai, Ai, Ai, Ai, Ai, Ai, Ai, Ai, Ai, Ai, Ai, Ai, Ai, Ai, Ai, Ai, Ai, Ai, Ai, Aa, Aa, Aa, Aa, Ha, Ha
Aa^Fpa, Aa^Fpa, Rb, Rb, Aa, Aa, Aa, Aa, Aa, Aa^Fpa, Aa^Fpa, Aa^Fpa, Aa^Fpa, Aa^Fpa, Aa^Fpa, Aa, Aa, Aa, Aa, Aa, Aa, Aa, Aa, Ai, Ai, Ai, Ai, Ai, Ai, Ai, Ai, Ai, Ai, Ai, Aa, Aa, Aa, Aa, Aa, Aa, Aa, Aa, Ha, Ha, Ha, Ha
