border_size=1
usage=map

Ha, Ha, Ha, Ha, Ha, Ha, Ha, Ha, Ha, Ha, Ha, Ha, Ha, Ha, Ha, Ha, Ha^Fpa, Ha^Fpa, Ha^Fpa, Ha^Fpa, Ha^Fpa, Ha^Fpa, Ha^Fpa, Ha^Fpa, Ha, Ha, Ha, Ha, Ha, Ha, Ha, Ha
Ha, Ha, Ha, Ha, Ha, Ha^Fpa, Ha^Fpa, Ha, Ha, Ha, Ha, Ha, Ha, Ha, Ha, Ha, Ha, Ha, Ha, Ha^Fpa, Ha, Ha^Fpa, Ha, Ha, Ha, Ha, Ha, Ha, Ha, Ha, Ha, Ha
Ha, Ha, Ha, Ha, Ha^Fpa, Ha^Fpa, Ha^Fpa, Ha, Ha, Ha, Ha, Ha, Ha, Ha, Ha, Ha, Ha, Ha, Ha, Ha, Ha, Ha^Fpa, Ha, Ha, Ha, Ha, Ha, Ha, Ha, Ha, Ha, Ha
Aa, Ha, Ha, Ha, Ha, Ha^Fpa, Ha, Ha, Ha, Ha, Ha, Ha^Fpa, Ha, Ha, Ha, Ha, Ha^Fpa, Ha, Ha, Ha, Ha, Ha, Ha, Ha, Ha, Ha, Ha, Ha, Ha, Ha, Aa, Ha
Aa, Aa, Ha, Ha, Ha, Ha, Ha, Ha, Ha, Ha, Ha, Ha, Ha, Ha, Ha, Ha, Ha, Ha, Ha, Ha, Ha, Ha, Ha, Ha, Aa, Ha, Aa, Ha, Ha, Aa, Aa, Aa
Ha, Aa, Ha, Ha, Ha, Ha, Ha, Ha, Ha, Ha, Ha, Ha, Ha, Ha, Ha, Ha, Ha, Ha, Ms, Ha, Ha, Aa, Aa, Aa, Ha, Aa, Aa, Aa, Aa, Aa, Aa, Aa
Ha, Ha, Ha, Ha, Ha, Ha^Fpa, Ha, Ha, Ha, Ha, Ha, Ha, Ha^Fpa, Ha^Fpa, Ha, Ha, Ha, Ha, Ha, Aa, Aa, Aa, Aa, Ha, Ha, Ha, Ha, Aa, Aa, Aa, Aa, Aa
Ha, Ha, Ha, Ha, Ha, Ha^Fpa, Ha, Ha^Fpa, Ha, Ha, Ha, Ha, Ha^Fpa, Ha, Ha, Ha, Ha, Ha, Ha, Ha, Aa, Aa, Ha, Ha, Ha, Ha, Ha, Ha, Ha, Aa, Aa, Aa
Ha, Ha, Ha, Ha, Ha, Ha, Ha, Ha, Ha, Ha, Ha, Ha, Ha, Ha, Ha, Ha, Ha, Ha, Ha, Ha, Coa, Aa, Ha, Ha, Ha, Ha, Ha, Ha, Ha, Ha, Aa, Aa
Ha, Ha, Ha, Ha, Ha, Ha, Ha, Ha, Ha^Fpa, Ha, Ha, Aa, Aa, Aa, Ha, Ha, Ha, Aa, Ha, Aa, Rb, Aa, Ha, Ha, Ha, Ha, Ha, Ha, Ha, Ha, Ha, Aa
Ha, Ha, Ha, Ha, Ha, Aa, Aa, Aa, Aa, Aa, Aa, Aa, Rb, Rb, Rb, Aa, Aa, Aa, Aa, Rb, Rb, Ha, Ha, Ha, Ha^Fpa, Ha, Ha, Ha, Ha, Ha, Ha, Ha
Ha, Ha, Rb, Ha, Rb, Rb, Rb, Rb, Rb, Rb, Rb, Rb, Rb, Rb, Rb, Rb, Rb, Rb, Rb, Rb, Aa, Aa, Ha, Ha, Ha^Fpa, Ha, Ha, Ha, Ha, Ha, Ha, Ha
Rb, Rb, Ha, Rb, Ha, Rb, Rb, Rb, Rb, Rb, 2 Rb, Aa, Aa, Rb, Aa, Aa, Aa, Aa, Aa, Rb, Rb, Aa, Ha, Ha, Ha, Ha, Ha, Ha, Ha, Ha, Ha, Ha
Ha, Ha, Ha, Ha, Ha, Ha, Aa, Aa, Aa, Rb, Ha, Ha, Ha, Ha, Ha, Ha, Ha, Ha, Aa, Rb, Rb, Aa, Ha, Ha, Ha, Ha, Ha, Ha, Ha, Ha, Ha, Ha
Ha, Ha, Ha, Ha, Ha, Ms, Ms, Ha, Ha, Ha, Ha, Ha, Ha, Ha, Ha, Ha, Ha, Aa, Rb, Rb, Rb, Aa, Aa, Ha^Fpa, Ha, Ha, Ha, Ha, Ha, Ha, Ha, Ha
Ha, Ha, Ha, Ha, Ha, Ms, Ms, Ha, Ha^Voa, Ha, Ha, Ha, Ha, Ms, Ha, Ha, Aa, Aa, Coa, Rb, Aa, Ha, Ha, Ha, Ha, Ha, Ha, Ha, Ha, Ha, Ha, Ha
Ha, Ha, Ha, Ha, Ha, Ha, Ha, Ha, Ha, Ha, Ha, Ms, Ms, Ms, Ha, Ha, Ha, Aa, Rb, Aa, Aa, Ha, Ha, Ha^Voa, Ha, Ha, Ha, Ha, Ha, Ha, Ha, Ha
Ha, Ha, Ha, Ha, Ha, Ha, Ha, Ha, Ha, Ha, Ha, Ha, Ms, Ha, Ha, Ha, Ha, Aa, Rb, Aa, Ha, Ms, Ha, Ha, Ha, Ha, Ha, Ha, Ha, Ha, Ha, Ha
Ha^Fpa, Ha, Ha, Ha, Ha, Ha, Ha, Ha, Ha, Ha, Ha, Ha, Ha, Ha, Ha, Ms, Ha, Aa, Rb, Aa, Ha, Ha, Ha, Ha, Ha, Ha, Ha, Ha, Ha, Ha, Ha, Ha
Ha^Fpa, Ha, Ha, Ha, Ha, Ms, Ms, Ha, Aa, Ha, Ha, Ha, Ha, Ms, Ms, Ha, Aa, Rb, Rb, Ha^Fpa, Ha, Ha, Ms, Ha, Ha, Ha, Ms, Ha, Ha, Ha, Ha, Ha
Ha^Fpa, Ha, Ha, Ha, Ha, Ha, Ha, Ha, Ha, Ms, Ms, Ms, Ms, Ms, Ha, Aa, Aa, Rb, Ha^Fpa, Ha^Fpa, Ha^Fpa, Ha, Ms, Ms, Ha, Ms, Ms, Ha, Ha, Ha, Ha, Ha
Ha, Ha^Fpa, Ha, Ha, Ha, Ha, Ha, Ha, Ms, Ha, Ms, Ms, Ms, Ha, Ha, Aa, Rb, Aa, Ha^Fpa, Ha, Ha, Ha, Ha, Ha, Ms, Ms, Ms, Ha, Ha, Ha, Ha, Ha
Ha, Ha^Fpa, Ha^Fpa, Ha, Ha, Ha, Ha, Ha, Ha, Ha, Ha, Ha, Ha, Ha, Aa, Aa, Rb, Rb, Aa, Ha, Ha, Ha, Ha, Ha, Ha, Ha, Ha, Ha, Ha, Ha, Ha, Ha
Ha, Ha, Ha, Ha, Ha, Ha, Ha, Ha, Ha, Ha, Ha, Ha, Ha, Aa, 1 Aa, Rb, Rb, Aa, Aa, Ha, Ha, Ha, Ha, Ha^Voa, Ha, Ha, Ha, Ha, Ha, Ha, Ha, Ha
Ha, Ha, Ha, Ha, Ha, Ha, Ha, Ha, Ha, Ha, Ha, Aa, Aa, Rb, Rb, Rb, Aa, Aa, Ha, Ha, Ha, Ha, Ha, Ha, Ha, Ha, Ha, Ha, Ha, Ha, Ha, Ha
Ha, Ha, Ha, Ha, Ha, Ha, Ha, Ha, Ha, Ha, Ha, Aa, Rb, Aa, Rb, Aa, Aa, Ha, Ha, Ha, Ha, Ha, Ha^Fpa, Ha, Ha, Ha, Ha, Ha, Ha, Ha, Aa, Ha
Ha, Ha, Ha, Ha, Ha, Ha^Fpa, Ha, Ha, Ha, Ha, Ha, Aa, Aa, Aa, Rb, Ha, Rb, Ha, Ha, Ha, Ha, Ha, Ha, Ha, Ha, Ha, Ha, Ha, Ha, Ha, Aa, Aa
Ha, Ha, Ha, Ha, Ha, Ha, Ha, Ha, Ha, Ha, Ha, Ha, Ha, Ha, Ha, Rb, Ha, Rb, Rb, Ha, Ha, Ha, Ha, Ha, Ha, Ha, Ha, Ha, Ha, Ha, Ha, Aa
Ha^Fpa, Ha, Ha, Ha, Ha, Ha, Ha, Ha, Ha, Ha, Ha, Ha, Ha, Ha, Ha, Ha, Ha, Ha, Ha, Rb, Rb, Rb, Rb, Rb, Rb, Ha, Rb, Ha, Ha, Ha, Ha, Ha
Ha^Fpa, Ha^Fpa, Ha, Ha, Ha, Ha, Ha, Ha, Ha, Ha, Ha, Ha, Ha, Ha, Ha, Ha, Ha, Ha, Ha, Ha, Ha, Ha, Ha, Rb, Ha, Rb, Rb, Rb, Rb, Ha, Ha, Ha
Ha, Ha, Ha, Ha, Ha, Ha, Ha, Ha^Fpa, Ha^Fpa, Ha, Ha, Ha, Ha, Ha, Ha, Ha, Ha^Fpa, Ha, Ha, Ha, Ha, Ha, Ha, Ha, Ha, Ha, Ha, Ha, Ha, Rb, Rb, Ha
Ha, Ha, Ha, Ha, Ha, Ha, Ha, Ha^Fpa, Ha^Fpa, Ha^Fpa, Ha^Fpa, Ha, Ha, Ha, Ha, Ha, Ha, Ha^Fpa, Ha^Fpa, Ha, Ha, Ha, Ha, Ha, Ha, Ha, Ha, Ha, Ha, Rb, Rb, Rb
