border_size=1
usage=map

Ha, Ha, Ha, Ha, Ha, Ha, Ha, Ha, Ha, Ha, Ha, Ha, Ha, Ha^Fpa, Ha^Fpa, Ha, Ha^Fpa, Ha, Ha, Ha, Ha, Ha, Ha, Ha, Ha, Ha, Ha, Ha, Ha, Ha, Ha, Ha
Ha, Ha, Ha, Ha, Ha^Fpa, Ha^Fpa, Ha^Fpa, Ha, Ha^Fpa, Ha, Ha, Ha, Ha, Ha^Fpa, Ha^Fpa, Ha^Fpa, Ha^Fpa, Ha^Fpa, Ha^Fpa, Ha, Ha, Ha, Ha, Ha, Ha, Ha, Ha, Ha, Ha, Ha, Ha, Ha
Ha, Ha, Ha, Ha, Ha, Ha, Ha, Ha, Ha, Ha, Ha, Ha, Ha, Ha, Ha, Ha^Fpa, Ha, Ha^Fpa, Ha^Fpa, Ha^Fpa, Ha, Ha, Ha, Ha, Ha, Ha, Ha, Ha, Ha, Ha, Ha, Ha
Ha, Ha, Ha, Ha, Ha, Ha, Ha, Ha, Ha, Ha, Ha, Ha, Ha, Ha, Ha, Ha, Ha, Ha, Ha, Ha, Aa, Aa, Aa, Aa, Aa, Ha, Aa, Aa, Aa, Ha, Ha, Ha
Ha, Ha, Ha, Ha, Ha, Ha, Ha, Ha, Ha, Ha, Ha, Ha, Ha, Ha, Ha, Ha, Ha, Ha, Ha, Ha, Ha, Aa, Aa, Aa, Aa, Aa, Ha, Ha, Ha, Aa, Ha, Ha
Ha^Fpa, Ha^Fpa, Ha, Ha, Ha, Ha, Ha, Ha, Ha, Ha, Ha, Ha, Ha, Ha, Ha, Ha, Ms, Ms, Ms, Ha, Ha, Aa, Aa, Aa, Ha, Aa, Aa, Ha, Ha, Ha, Ha, Ha
Ha, Ha, Ha, Ha, Ha, Ha^Fpa, Ha, Ha, Ha, Ha^Fpa, Ha, Ha^Fpa, Ha^Fpa, Ha^Fpa, Ha, Ha, Ha, Ha, Ha, Ha, Ha, Aa, Aa, Aa, Ha, Ha, Ha, Ha, Ha, Ha, Ha, Ha
Ha, Ha, Ha, Ha, Ha, Ha^Fpa, Ha, Ha^Fpa, Ha, Ha, Ha^Fpa, Ha, Ha^Fpa, Ha, Ha, Ha, Ha, Ha, Ha, Ha, Ha, Aa, Aa, Aa, Ha, Ha, Ha, Ha, Ha, Ha, Ha, Ha
Ha, Ha, Ha, Ha, Ha, Ha, Ha, Ha, Ha, Ha^Fpa, Ha, Ha, Ha, Ha, Ha, Cha, Ha, Ha, Ha, Aa, Rb, Rb, Rb, Aa, Ha, Ha, Ha, Ha, Ha, Ha, Ha, Ha
Ha, Ha, Ha, Ha, Ha, Ha, Ha, Ha, Ha^Fpa, Ha, Ha, Ha, Aa, Aa, Aa, Rb, Rb, Aa^Vha, Aa, Rb, Rb, Aa, Aa, Ha, Ha, Ha, Ha, Ha, Ha, Ha, Ha, Ha
Ha, Ha, Ha, Ha, Ha^Fpa, Ha, Ha, Ha, Ha, Ha, Aa, Aa, Aa, Rb, Rb, Rb, Rb, Rb, Rb, Rb, Aa, Ha, Ha, Ha, Ha^Fpa, Ha, Ha, Ha, Ha, Ha, Ha, Ha
Ha, Ha, Ha, Ha, Ha, Ha^Fpa, Ha, Aa, Aa, Ha, Aa, Aa, Rb, Rb, Rb, Rb, Aa, Aa, Aa, Aa, Aa, Ha, Ha, Ha, Ha^Fpa, Ha, Ha, Ha, Ha, Ha, Ha, Ha
Ha, Ha, Ha, Ha, Ha, Ha, Ha, Aa, Ha, Aa, 2 Rb, Rb, Rb, Ha, Ha, Aa^Fpa, Aa, Aa, Ha, Ha, Ha, Ha, Ha, Ha, Ha, Ha, Ha, Ha, Ha, Ha, Ha, Ha
Ha, Ha, Ha, Ha, Ms, Ha, Ha, Aa, Aa, Aa, Aa, Rb, Rb, Aa, Ha, Aa, Rb, Rb, Aa, Ha, Ha, Ha, Ha, Ha, Ha, Ha, Ha, Ha, Ha, Ha, Ha, Ha
Ha, Ha, Ms, Ms, Ms, Ms, Ms, Ha, Ha, Aa, Aa^Fpa, Aa, Rb, Rb, Rb, Rb, Rb, Ha, Ha, Ha, Ha, Ha, Ha^Fpa, Ha^Fpa, Ha, Ha, Ha, Ha, Ha, Ha, Ha, Ha
Ha, Ha, Ha, Ha, Ha, Ms, Ms, Ha, Ha, Ha, Ha, Aa, Rb, Rb, Ha, Ha, Ha, Ms, Ha, Ha, Ha, Ha, Ha, Ha, Ha, Ha, Ha, Ha, Ha, Ha, Ha, Ha
Ha, Ha, Ha, Ha, Ha, Ha, Ha, Ha, Ha, Ha, Ha, Aa, Rb, Rb, Aa, Ha, Ha, Ha, Ha, Ha, Ha, Ha, Ha, Ha, Ha, Ms, Ha, Ms, Ms, Ha, Ha, Ha
Ha, Ha, Ha, Ha, Ha, Ha, Ha, Ha, Ha, Ha, Ha, Aa, Aa, Rb, Aa, Ha, Ha, Ha, Ha, Ha, Ha, Ms, Ha, Ha, Ms, Ms, Ha, Ms, Ms, Ha, Ha, Ha
Ha, Ha, Ha, Ha, Ha, Ha, Ha, Ha, Ha, Ha, Ha, Cha, Aa, Rb, Aa, Ha, Ha, Ha, Ha, Ha, Ha, Ha, Ha, Ms, Ms, Ms, Ms, Ms, Ms, Ha, Ha, Ha
Ha, Ha, Ha, Ha, Ha, Ms, Ms, Ha, Aa, Ha, Ha, Aa, Aa, Rb, Aa, Ha, Ha, Ha, Ha^Fpa, Ha^Fpa, Ha, Ha, Ms, Ms, Ms, Ms, Ms, Ha, Ms, Ha, Ha, Ha
Ha, Ha, Ms, Ha, Ms, Ha, Ha, Ha, Ha, Ha^Fpa, Ha, Ha, Aa, Rb, Aa, Aa, Ha, Ha, Ha^Fpa, Ha^Fpa, Ha^Fpa, Ha, Ms, Ms, Ms, Ms, Ms, Ms, Ms, Ha, Ha, Ha
Ha, Ha, Ha, Ms, Ha, Ha, Ha, Ha, Ha^Fpa, Ha^Fpa, Ha, Ha, Aa, Rb, Rb, Aa, Ha, Ha, Ha^Fpa, Ha, Ha, Ha, Ha, Ha, Ms, Ms, Ms, Ha, Ha, Ha, Ha, Ha
Ha, Ha, Ha, Ha, Ha, Ha, Ha, Ha, Ha, Ha^Fpa, Ha, Ha, Aa, Rb, Rb, Aa, Ha, Ha, Ha, Ha, Ha, Ha, Ha, Ha, Ha, Ha, Ha, Ha, Ha, Ha, Aa^Fpa, Ha
Ha, Ha, Ha, Ha, Ha, Ha, Ha, Ha, Ha, Ha, Ha, Ha, Aa, Aa, 1 Rb, Aa, Ha, Ha, Ha, Ha, Ha, Ha, Ha, Ha, Ha, Ha, Aa, Ha, Aa, Ha, Aa, Aa
Ha, Ha, Ha, Ha, Ha, Ha^Fpa, Ha, Ha, Ha, Ha, Ha, Ha, Aa, Aa, Rb, Aa^Vha, Aa, Aa, Ha, Ha, Ha, Ha, Ha, Ha, Ha, Aa, Aa, Aa, Aa, Aa, Aa^Fpa, Aa
Ha, Ha, Ha, Ha, Ha, Ha^Fpa, Ha^Fpa, Ha, Ha, Ha, Ha, Ha, Ha, Ha, Rb, Aa, Aa, Aa, Ha, Ha, Ha, Ha^Fpa, Ha^Fpa, Ha, Ha, Aa, Aa, Aa, Ha, Aa, Ha, Aa^Fpa
Ha, Ha, Ha, Ha, Ha, Ha^Fpa, Ha^Fpa, Ha, Ha, Ha^Fpa, Ha, Ha, Ha, Ha, Aa, Rb, Aa, Aa, Ha, Ha, Ha^Fpa, Ha^Fpa, Ha^Fpa, Ha, Ha, Ha, Ha, Aa, Ha, Ha, Ha, Ha
Ha, Ha, Ha, Ha, Ha, Ha, Ha, Ha, Ha, Ha, Ha, Ha, Ha, Ha, Ha, Ha, Ha, Ha, Ha, Ha, Ha, Ha, Ha, Ha, Ha, Ha, Ha, Ha, Ha, Ha^Fpa, Ha, Ha
Ha, Ha, Ha, Ha, Ha, Ha, Ha, Ha, Ha, Ha, Ha, Ha, Ha, Ha, Ha, Ha, Ha, Ha, Ha, Ha, Ha, Ha, Ha, Ha, Ha, Ha, Ha, Ha, Ha, Ha, Ha, Ha
Ha, Ha, Ha, Ha, Ha, Ha, Ha, Ha, Ha, Ha, Ha, Ha, Ha, Ha, Ha, Ha, Ha, Ha, Ha, Ha, Ha, Ha, Ha, Ha, Ha, Ha, Ha, Ha, Ha, Ha, Ha, Ha
Ha, Ha, Ha, Ms, Ms, Ha, Ha, Ha, Ha, Ha, Ha, Ha, Ha, Ha, Ha^Fpa, Ha, Ha, Ha, Ha, Ha, Ha, Ha, Ha, Ha, Ha, Ha, Ha^Fpa, Ha, Ha, Ha, Ha, Ha
Ha, Ha, Ms, Ms, Ms, Ms, Ms, Ha, Ha, Ha, Ha^Fpa, Ha^Fpa, Ha^Fpa, Ha^Fpa, Ha, Ha^Fpa, Ha, Ha, Ha, Ha, Ha, Ha, Ha, Ha, Ha, Ha^Fpa, Ha^Fpa, Ha, Ha, Ha, Ha, Ha
