border_size=1
usage=map

Ha^Fpa, Ha, Ha^Fpa, Ha, Ha^Fpa, Ha, Ha, Ha, Ha^Fpa, Ha, Ha, Ha, Ms, Ms, Ms, Ms, Ms, Ha, Ms, Ms, Ms, Ha, Ha, Ha, Ha, Ha, Ha, Ha, Ha^Fpa, Ha, Ha, Ha
Ha^Fpa, Ha, Ha, Ha, Ha, Ha^Fpa, Ha, Ha, Ha, Ha, Ha, Ha, Ha, Ms, Ms, Ms, Ms, Ms, Ha, Ha, Ha, Ha, Ha, Ha, Ha, Ha, Ha, Ha^Fpa, Wwg, Ha^Fpa, Ha, Ha
Ha, Ha, Ha^Fpa, Ha^Fpa, Ha, Ha, Ha, Ha, Ha, Ha, Ha, Ha, Ha, Ha, Ha, Ha, Ha, Ms, Ha, Ha, Ha, Ha, Ha, Ha, Ha, Aa, Aa, Wwg, Wwg, Ai, Ha, Ha
Ha, Ha^Fpa, Ha^Fpa, Ha, Ha, Ha, Ha, Ha, Ha, Ha, Ha, Ha, Ha, Ha, Ha, Ha, Ha, Ha, Ha, Ha, Ha, Ha, Ha, Ha, Ha, Aa, Aa, Ai, Ai, Ai, Ha, Ha
Ha^Fpa, Ha, Ha^Fpa, Ha, Ha, Ha, Ha, Ha, Ha, Ha, Ha, Ha, Ha, Ha, Ha, Ha, Ha, Ha, Ha, Ha, Ha, Ha, Ha, Ha, Ha, Ha, Aa, Ai, Aa, Ai, Ha, Ha
Ha^Fpa, Ha, Ha, Ha, Ha, Ha, Ha, Ha, Ha, Ha, Ha, Ha, Ha, Ha, Ha, Ha, Ms, Ms, Ms, Ms, Ms, Ms, Ha, Ha, Ha, Ha, Ha, Aa, Ha, Ha, Ha, Ha
Ha, Ha, Ha, Ha, Ha, Ha^Fpa, Ha, Ha, Ha, Ha, Ha, Ha, Ha^Fpa, Ha^Fpa, Ha, Ha, Ha, Ha, Ha, Ha, Ha, Ha, Ha, Ha, Ha, Ha, Ha, Ha, Ha, Ha, Ha^Fpa, Ha
Ms, Ms, Ms, Ha, Ha, Ha^Fpa, Ha^Fpa, Ha^Fpa, Ha, Ha, Koa, Ha, Ha^Fpa, Ha^Fpa, Ha^Fpa, Ha^Fpa, Ha, Ha, Ha, Ms, Ha, Ms, Ha, Ha, Ha, Ha, Ha, Ha, Ha, Ha, Ha, Ha^Fpa
Ms, Ms, Ms, Ha, Ha, Ha, Ha^Fpa, Ha, Ha, Ha, Rb, Ha, Ha, Ha, Ha^Fpa, Ha, Ha^Fpa, Ha^Fpa, Ha, Ha, Ha, Ms, Ha, Ha, Ha, Ha, Ha, Ha, Ha, Ha, Ha, Ha^Fpa
Ha, Ms, Ha, Ha, Ha, Ha, Ha, Ha, Ha, Aa, Rb, Ha, Ha, Ha, Ha, Ha, Ha, Ha, Ha, Ha, Ha, Ha, Ha, Ha, Ha, Ha, Ha, Ha, Ha, Ha, Ha, Ha
Ha, Ha, Ha, Ha, Ha, Ha, Ha, Ha, Ha, Ha, Aa, Rb, Ha, Ha, Ha, Ha, Ha, Aa, Aa, Aa^Voa, Aa, Aa, Ha, Ha, Ha^Fpa, Ha, Ha, Ha, Ha, Ha, Ha, Ha
Ha, Ha, Ha, Ha, Ha, Ha, Ha, Ha, Ha, Aa, Aa, Rb, Rb, Aa, Aa, Aa, Aa, Aa, Rb, Rb, Aa, Aa, Ha, Ha, Ha^Fpa, Ha, Ha, Ha, Ha, Ha, Ha, Ha
Ha, Ha, Ha, Ha, Ha, Ha, Ha, Aa^Fpa, Aa^Fpa, Aa, 1 Aa, Aa, Aa^Fpa, Rb, Rb, Rb, Rb, Rb, Aa, Aa, Aa, Ha, Ha, Ha, Ha, Ha, Ha, Ha, Ha, Ha, Ha, Ha
Ha, Ha, Ha, Ha, Ha, Ha, Ha, Ha, Aa^Fpa, Aa^Fpa, Aa, Aa, Aa, Rb, Rb, Aa, Aa, Ha, Ha, Ha, Ha, Ha, Ha, Ha, Ha, Ha, Ha, Ha, Ha, Ha, Ha, Ha
Ha, Ha, Ha, Ha, Ha, Ms, Ms, Ha, Ha, Ha, Ha, Ha, Rb, Rb, Ha, Ha, Ha, Ha, Ha, Ha, Ha, Ha, Ha^Fpa, Ha^Fpa, Ha, Ha, Ha, Ha, Ha, Ha, Ha, Ha
Ha, Ha, Ha, Ha, Ha, Ms, Ms, Ha, Ha, Ha, Ha, Rb, Ha, Ha, Ha, Ha, Ha, Ms, Ha, Ha, Ha, Ha, Ha, Ha, Ha, Ha, Ha, Ha, Ha, Ha, Ha, Ha
Ha, Ha, Ms, Ms, Ms, Ms, Ms, Ha, Ha, Ha, Ha, Rb, Rb, Aa, Ha, Ha, Ha, Ha, Ha, Ha, Ha, Ha, Ha, Ha, Ha, Ms, Ha, Ha, Ms, Ha, Ha, Ha
Ha, Ms, Ms, Ha, Ms, Ms, Ms, Ha, Ha, Aa^Fpa, Aa, Rb, Rb, Rb, Aa, Ha, Ha, Ha, Ha, Ha, Ha, Ms, Ha, Ha, Ms, Ms, Ha, Ms, Ms, Ha, Ha, Ha
Ha, Ms, Ms, Ms, Ha, Ms, Ms, Ha, Ha, Aa, Aa, Rb, Rb, Rb, Rb, Ha, Ha, Ha, Ha, Ha, Ha, Ha, Ha, Ms, Ms, Ms, Ms, Ms, Ms, Ms, Ha, Ha
Ha, Ha, Ha, Ha, Ha, Ms, Ms, Ha, Aa, Aa, Rb, Rb, Aa^Fpa, Ha, Ha, Ha, Ha, Ha, Ha, Ha, Ha, Ha, Ms, Ms, Ms, Ms, Ms, Ms, Ha, Ha, Ha, Ha
Ha, Ha, Ha, Ha, Ha, Ms, Ha, Aa, Rb, Rb, Rb, Rb, Aa, Aa, Ha, Aa, Koa, Aa, Ha, Ha, Ha, Ha, Ms, Ms, Ms, Ms, Ms, Ha, Ha, Ha, Ha, Ha
Ha, Ha, Ha, Ha, Aa, Aa, Aa, Aa, Rb, Rb, Rb, Rb, Rb, Rb, 2 Rb, Rb, Aa, Aa, Ha, Ha, Ha, Ha, Ha, Ha, Ms, Ms, Ms, Ha, Ha, Ha, Ha, Ha
Ha, Ha, Aa, Aa, Aa, Aa, Aa^Voa, Aa, Aa, Aa, Aa, Aa, Aa, Aa, Rb, Aa, Aa, Ha, Ha, Ha, Ha, Ha, Ha, Ha, Ha, Ha, Ha, Ha, Ha, Ms, Ha, Ha
Aa, Aa, Ha, Ha, Ha, Aa, Aa, Ha, Ha, Ha, Aa^Fpa, Ha, Ha, Ha, Rb, Rb, Ha, Ha, Ha, Ha, Ha, Ha, Ha, Ha, Ha, Ha, Ha, Ha, Ha, Ha, Ha, Ha
Ha, Ha, Ha, Ha, Ha, Ha^Fpa, Ha, Ha, Ha, Ha^Fpa, Ha, Ha, Ha, Ha, Rb, Ha, Ha, Ha, Ha, Ha, Ha, Ha, Ha, Ha, Ha, Ha, Ha, Ha, Ha, Ha, Ha, Ha
Ha, Ha, Ha, Ha, Ha, Ha^Fpa, Ha^Fpa, Ha, Ha, Ha^Fpa, Ha, Ha, Ha, Ha, Ha, Rb, Rb, Ha, Ha, Ha, Ha, Ha^Fpa, Ha^Fpa, Ha, Ha, Ha, Ha, Ha, Ha, Ha, Ha, Ha
Ha, Ha, Ha, Ha, Ha, Ha^Fpa, Ha^Fpa, Ha, Ha, Ha^Fpa, Ha^Fpa, Ha, Ha, Ha, Ha, Ha, Rb, Ha, Ha, Ha, Ha^Fpa, Ha^Fpa, Ha^Fpa, Ha, Ha, Ha, Ha, Ha, Ha, Ha, Ha, Ha
Ha, Ha, Ha, Ha, Ha, Ha, Ha, Ha, Ha, Ha, Ha, Ha, Ha, Ha, Ha, Ha, Rb, Ha, Ha, Ha, Ha, Ha, Ha, Ha, Ha, Ha, Ha, Ha, Ha^Fpa, Ha^Fpa, Ha, Ha
Ha, Ha, Ha, Ha, Ha, Ha^Fpa, Ha, Ha, Ha, Ha, Ha, Ha, Ha, Ha, Ha, Ha, Rb, Ha, Ha, Ha, Ha, Ha, Ha, Ha, Ha, Ha, Ha, Ha, Ha, Ha^Fpa, Ha^Fpa, Ha
Ha, Ha, Ha, Ha, Ha, Ha, Ha, Ha, Ha, Ha, Ha, Ha, Ha, Ha, Rb, Rb, Ha, Ha, Ha, Ha, Ha, Ha, Ha, Ha, Ha, Ha, Ha, Ha, Ha, Ha, Ha, Ha
Ha, Ha, Ha, Ha, Ha, Ha, Ha, Ha, Ha, Ha, Ha, Ha, Ha, Ha, Rb, Ha, Ha, Ha, Ha, Ha, Ha, Ha, Ha^Fpa, Ha, Ha, Ha, Ha, Ha, Ha, Ha, Ha, Ha
Ha^Fpa, Ha^Fpa, Ha, Ha, Ha, Ha, Ha, Ha, Ha, Ha, Ha, Ha, Ha, Ha, Rb, Rb, Ha, Ha, Ha, Ha, Ha^Fpa, Ha^Fpa, Ha^Fpa, Ha^Fpa, Ha^Fpa, Ha, Ha, Ha, Ha, Ha, Ha, Ha
