Xu, Xu, Xu, Xu, Xu, Xu, Xu, Xu, Xu, Xu, Xu, Xu, Xu, Xu, Wog, Wog, Xu, Xu, Xoym, Rrc^Ii, Brym^Ii, Brym^Ii, Brym^Ii, Brym^Ii, Brym^Ii, Rrc, Rrc, Xoym, Xu, Xu, Xu, Xu, Xu, Xu, Xu, Xu, Xu, Xu, Xu, Uu, Uu, Xu
Xu, Xu, Xu, Xu, Xu, Xu, Xoa, Xu, Xu, Xu, Xu, Xu, Tb^Tf, Tb^Tf, Wog, Wog, Xu, Xu, Xoym, Rrc^Ii, Rrc^Ii, Brym^Ii, Brym^Ii, Brym^Ii, Brym^Ii, Rrc, Xoym, Xoym, Xu, Xu, Xu, Xu, Xu, Xu, Xu, Xu, Xu, Xu, Uu, Uu, Uu, Xu
Xu, Xu, Xu, Xu, Xoa, Xoa, Urb, Xoa, Xoa, Xu, Xu, Xu, Tb^Tf, Tb^Tf, Wog, Wog, Xu, Xu, Xoym, Rrc, Rrc, Rrc, Brym, 1 Brym, Brym, Rrc, Xoym, Xu, Xu, Xu, Xu, Xu, Xu, Xu, Uu, Xu, Uu, 2 Uh, Uu, Uu, Xu, Xu
Xu, Xu, Xu, Xu, Xoa, Urb, Urb, Urb, Xoa, Xu, Xu, Xu, Tb^Tf, Tb^Tf, Wog, Wog, Xu, Xu, Xu, Xoym, Xoym, Rrc, Rrc, Brym, Brym, Rrc, Xoym, Xu, Xoym, Xoym, Xoym, Xoym, Xu, Uu^Vu, Rr, Rr, Rr, Uu, Uh, Xu, Xu, Xu
Xu, Xu, Xu, Xu, Xoa, Rr, Uu, Ur, Rr^Pr/, Xu, Xu, Xu, Xu, Tb^Tf, Wog, Wog, Xu, Xu, Xu, Xu, Xu, Xoym, Xoym, Brym, Brym, Rrc, Xoym, Xoym, Brym, Xoym, Brym, Xoym, Xoym, Uu^Em, Rr, Rr, Rr, Uu, Xu, Uh, Xu, Xu
Xu, Xu, Xu, Xoa, Uu, Rr^Pr\, Xoa, Rr^Pr/o, Ur^Em, Tb^Tf, Ur^Em, Xu, Xu, Tb^Tf, Wog, Wog, Xu, Xu, Xu, Xu, Xu, Xu, Xoym, Brym, Brym, Brym, Brym, Xoym, Brym, Brym, Brym, Brym, Uu^Em, Tb^Tf, Uu^Em, Uu, Uu, Uu, Xu, Xu, Xu, Xu
Xu, Xu, Xu, Xoa, Uu, Rr, Xoa^Efs, Uu, Xoa, Ur^Em, Rr, Xu, Xu, Xu, Wog, Wog, Tb^Tf, Xu, Xu, Xu, Xu, Xu, Xoym, Rrc, Rrc, Brym, Brym, Brym, Brym, Brym, Brym, Brym, Xoym, Tb^Tf, Uu^Em, Uu, Xu, Uu, Xu, Xu, Xu, Xu
Xu, Xu, Xu, Xu, Xu, Rr, Uu, Rr, Xoa, Ur, Urb, Xoa, Xu, Xu, Wog, Wog, Wog, Xu, Xu, Xu, Xu, Xu, Xu, Xoym, Xoym, Xoym, Xoym, Brym, Brym, Brym, Brym, Brym, Xoym, Xu, Xu, Xu, Xu, Uu, Uu, Xu, Xu, Xu
Xu, Xu, Xu, Xu, Xu, Ur, Ur, Xoa, Xu, Xoa, Urb, Xoa, Xu, Xu, Xu, Wog, Wog, Wog, Wog, Xu, Xu, Xu, Xu, Xu, Xu, Xu, Xu, Xoym, Brym, Brym, Brym, Brym, Xoym, Xu, Xu, Xu, Uu^Vu, Xu, Uu, Xu, Xu, Xu
Xu, Xu, Xu, Xu, Xu, Ur, Uu^Em, Uh, Xu, Xoa, Ur^Edt, Xoa, Xu, Xu, Xu, Xu, Xu, Wog, Wog, Wog, Wog, Wog, Wog, Xu, Xu, Xu, Xu, Xoym, Brym, Brym, Brym, Brym, Xoym, Xu, Xu, Uu, Uu, Uu, Xu, Xu, Xu, Xu
Xu, Xu, Xu, Xu, Xuc, Ur^Em, Uu, Uu^Vu, Xu, Xoa, Uu^Edt, Xoa, Xu, Xu, Xu, Xu, Tb^Tf, Wog, Wog, Wog, Wog, Wog, Wog, Wog, Xu, Xu, Xu, Xoym, Brym^Bryu, Brym, Brym, Brym, Xoym, Xu, Xu, Xu, Xu, Uu, Uu, Xu, Xu, Xu
Xu, Xu, Xu, Uu^Vu, Uu^Em, Ur, Uu, Xu, Xu, Uu^Edt, Uu^Edt, Uu^Edt, Xu, Xu, Xu, Xu, Xu, Wog, Wog, Wog, Wog, Wog, Wog, Wog, Wog, Xu, Xu, Xoym, Brym, Brym, Brym, Brym, Xoym, Xoym, Xu, Xu, Xu, Xu, Xu, Tb^Tf, Uu, Xu
Xu, Xu, Xu, Uu^Tf, Uu^Em, Ur^Em, Uu^Em, Xuc, Xu, Xu, Ur^Edt, Xu, Xu, Xu, Xu, Xu, Xu, Xu, Xu, Wog, Xu, Wog, Wog, Wog, Wog, Xu, Xu, Xu, Ur, Ur, Ur, Rrc, Xoa, Xoym, Xu, Xu, Xu, Xu, Uu, Uu, Xu, Xu
Xu, Xu, Xu, Uu^Em, Uu^Em, Ur^Em, Uu^Em, Uu^Tf, Xuc, Xu, Xu, Ur, Ur^Edt, Xuc, Uu^Edt, Xu, Xu, Xu, Xu, Xu, Xu, Rb^Tf, Rb^Em, Wwg, Wwg, Xu, Xu, Xu, Xu, Ur, Ur, Uu, Rr, Xoa, Uu, Xu, Xu, Uu, Uu, Xu, Xu, Xu
Xu, Xu, Xu, Xuc, Uu^Em, Ur^Em, Ur^Em, Uh, Uu^Em, Xuc, Xu, Xu, Xu, Ur^Edt, Ur^Edt, Uu^Edt, Uu^Edt, Uu^Vu, Xu, Xu, Xu, Rb^Em, Xu, Wwg^Bw\r, Wwg^Bw\r, Rb^Em, Uh, Xu, Xu, Xu, Xu, Ur, Uu, Rr, Rr, Xu, Uu, Uu, Uu, Xu, Xu, Xu
Xu, Xu, Xu, Xu, Uh, Uu^Em, Uu^Tf, Ur^Em, Uu^Tf, Tb^Tf, Tb^Tf, Xu, Qxu, Qxu, Xu, Ur^Edt, Uu^Edt, Xu, Xu, Xu, Uu^Em, Rb^Em, Xu, Xu, Xu, Rb, Xu, Xu, Xu, Xu, Xu, Xu, Uu, Rr, Rr, Uu, Xu, Uu, Xu, Xu, Xu, Xu
Xu, Xu, Xu, Tb^Tf, Uh, Uh, Xu, Ur^Em, Uu^Tf, Uu^Tf, Ur^Tf, Uu^Tf, Uu^Em, Qxu, Xuc, Xu, Xu, Xu, Rb^Em, Rb^Es, Rb, Rb^Em, Xu, Xu, Rb, Wwf, Xu, Xu, Xu, Xu, Uh, Uu, Uu, Rr, Uu, Xu, Xu, Xu, Xu, Xu, Xu, Xu
Xu, Xu, Xu, Xu, Xu, Xu, Xu, Ur^Em, Ur^Em, Ur^Em, Uu^Em, Ur^Em, Ur^Em, Re, Re^Es, Xu, Cer, Xu, Rb^Em, Rb^Em, Xu, Xu, Xu, Xu, Wwg^Bw|r, Xu, Xu, Xu, Tb^Tf, Xu, Xu, Xu, Xu, Uu^Tf, Wwg^Tf, Xuc, Rb^Em, Xuc, Xuc, Xu, Xu, Xu
Xu, Xu, Xu, Xu, Xu, Xu, Xu, Xu, Xu, Xu, Xu, Uu^Em, Ur^Tf, Re^Es, Re, Re, Re, Re, Re, Xu, Xu, Xu, Wog, Wwg, Wwg^Bw\r, Xu, Xuc, Xu, Rb^Tf, Rb^Tf, Rb, Xu, Xu, Uu^Tf, Uu^Vu, Wwrg, Xuc, Tb^Tf, Xuc, Xu, Xu, Xu
Xu, Xu, Xu, Xu, Xu, Xu, Xu, Xu, Xu, Xu, Xu, Xu, Xu, Uu^Vu, Xu, Re^Tf, Chw, Re, Tb, Xu, Xu, Tb, Wog, Wog, Wwg, Rb^Em, Rb, Rb, Xu, Xu, Xu, Rb^Edt, Rb, Xu, Xuc, Xuc, Wwrg, Rb^Em, Xu, Xu, Xu, Xu
Xu, Xu, Xu, Xu, Xu, Xu, Xu, Xu, Xu, Xu, Xu, Xu, Xu, Xu, Xu, Xu, Wog, Wog, Sm, Xu, Uu^Tf, Wog, Wog, Wog, Xu, Xu, Uu^Vu, Xu, Xu, Xu, Xu, Xu, Wwf, Wwf, Wwg, Wwf, Xu, Xu, Xu, Xu, Xu, Xu
Xu, Xu, Xu, Xu, Xu, Xu, Xu, Xu, Xu, Xu, Xu, Xu, Xu, Xu, Xu, Xu, Wog, Wog, Xu, Xu, Xu, Wog, Wog, Xu, Xu, Xu, Xu, Xu, Xu, Xu, Xu, Xu, Xu, Xu, Xu, Xu, Xu, Xu, Xu, Xu, Xu, Xu
