Xu, Xu, Xu, Xu, Xu, Xu, Xu, Xu, Xu, Xu, Xu, Xu, Xu, Xu, Wog, Wog, Xu, Xu, Xoym, Rrc^Ii, Brym^Ii, Brym^Ii, Brym^Ii, Brym^Ii, Brym^Ii, Rrc, Rrc, Xoym, Xu, Xu, Xu, Xu, Xu, Xu, Xu, Xu, Xu, Xu, Xu, Uu, Uu, Xu
Xu, Xu, Xu, Xu, Xu, Xu, Xos, Xu, Xu, Xu, Xu, Xu, Uu^Uf, Uu^Uf, Wog, Wog, Xu, Xu, Xoym, Rrc^Ii, Rrc^Ii, Brym^Ii, Brym^Ii, Brym^Ii, Brym^Ii, Rrc, Xoym, Xoym, Xu, Xu, Xu, Xu, Xu, Xu, Xu, Xu, Xu, Xu, Uu, Uu, Uu, Xu
Xu, Xu, Xu, Xu, Xos, Xol, Urb, Xol, Xos, Xu, Xu, Xu, Uu^Uf, Uu^Uf, Wog, Wog, Xu, Xu, Xoym, Rrc, Rrc, Rrc, Brym, 1 Brym, Brym, Rrc, Xoym, Xu, Xu, Xu, Xu, Xu, Xu, Xu, Uu, Xu, Uu, 2 Uh, Uu, Uu, Xu, Xu
Xu, Xu, Xu, Xu, Xos, Urb, Urb, Urb, Xos, Xu, Xu, Xu, Uu^Uf, Uu^Uf, Wog, Wog, Xu, Xu, Xu, Xoym, Xoym, Rrc, Rrc, Brym, Brym, Rrc, Xoym, Xu, Xoym, Xoym, Xoym, Xoym, Xu, Uu^Vu, Rr, Rr, Rr, Uu, Uh, Xu, Xu, Xu
Xu, Xu, Xu, Xu, Xos, Rr, Uu, Ur, Rr^Pr/, Xu, Xu, Xu, Xu, Uu^Uf, Wog, Wog, Xu, Xu, Xu, Xu, Xu, Xoym, Xoym, Brym, Brym, Rrc, Xoym, Xoym, Brym, Xoym, Brym, Xoym, Xoym, Uu^Em, Rr, Rr, Rr, Uu, Xu, Uh, Xu, Xu
Xu, Xu, Xu, Xos, Uu, Rr^Pr\, Xos, Rr^Pr/o, Ur^Em, Uu^Uf, Ur^Em, Xu, Xu, Uu^Uf, Wog, Wog, Xu, Xu, Xu, Xu, Xu, Xu, Xoym, Brym, Brym, Brym, Brym, Xoym, Brym, Brym, Brym, Brym, Uu^Em, Uu^Uf, Uu^Em, Uu, Uu, Uu, Xu, Xu, Xu, Xu
Xu, Xu, Xu, Xos, Uu, Rr, Xos^Efs, Uu, Xos, Ur^Em, Rr, Xu, Xu, Xu, Wog, Wog, Uu^Uf, Xu, Xu, Xu, Xu, Xu, Xoym, Rrc, Rrc, Brym, Brym, Brym, Brym, Brym, Brym, Brym, Xoym, Uu^Uf, Uu^Em, Uu, Xu, Uu, Xu, Xu, Xu, Xu
Xu, Xu, Xu, Xu, Xu, Rr, Uu, Rr, Xos, Ur, Urb, Xos, Xu, Xu, Wog, Wog, Wog, Xu, Xu, Xu, Xu, Xu, Xu, Xoym, Xoym, Xoym, Xoym, Brym, Brym, Brym, Brym, Brym, Xoym, Xu, Xu, Xu, Xu, Uu, Uu, Xu, Xu, Xu
Xu, Xu, Xu, Xu, Xu, Ur, Ur, Xos, Xu, Xos, Urb, Xos, Xu, Xu, Xu, Wog, Wog, Wog, Wog, Xu, Xu, Xu, Xu, Xu, Xu, Xu, Xu, Xoym, Brym, Brym, Brym, Brym, Xoym, Xu, Xu, Xu, Uu^Vu, Xu, Uu, Xu, Xu, Xu
Xu, Xu, Xu, Xu, Xu, Ur, Uu^Em, Uh, Xu, Xos, Ur^Edt, Xos, Xu, Xu, Xu, Xu, Xu, Wog, Wog, Wog, Wog, Wog, Wog, Xu, Xu, Xu, Xu, Xoym, Brym, Brym, Brym, Brym, Xoym, Xu, Xu, Uu, Uu, Uu, Xu, Xu, Xu, Xu
Xu, Xu, Xu, Xu, Xuc, Ur^Em, Uu, Uu^Vu, Xu, Xos, Uu^Edt, Xos, Xu, Xu, Xu, Xu, Uu^Uf, Wog, Wog, Wog, Wog, Wog, Wog, Wog, Xu, Xu, Xu, Xoym, Brym^Bryu, Brym, Brym, Brym, Xoym, Xu, Xu, Xu, Xu, Uu, Uu, Xu, Xu, Xu
Xu, Xu, Xu, Uu^Vu, Uu^Em, Ur, Uu, Xu, Xu, Uu^Edt, Uu^Edt, Uu^Edt, Xu, Xu, Xu, Xu, Xu, Wog, Wog, Wog, Wog, Wog, Wog, Wog, Wog, Xu, Xu, Xoym, Brym, Brym, Brym, Brym, Xoym, Xoym, Xu, Xu, Xu, Xu, Xu, Uu^Uf, Uu, Xu
Xu, Xu, Xu, Uu^Uf, Uu^Em, Ur^Em, Uu^Em, Xuc, Xu, Xu, Ur^Edt, Xu, Xu, Xu, Xu, Xu, Xu, Xu, Xu, Wog, Xu, Wog, Wog, Wog, Wog, Xu, Xu, Xu, Ur, Ur, Ur, Rrc, Xoym, Xoym, Xu, Xu, Xu, Xu, Uu, Uu, Xu, Xu
Xu, Xu, Xu, Uu^Em, Uu^Em, Ur^Em, Uu^Em, Uu^Uf, Xu, Xu, Xu, Ur, Ur^Edt, Xu, Uu^Edt, Xu, Xu, Xu, Xu, Xu, Xu, Rb^Uf, Rb^Em, Wwg, Wwg, Xu, Xu, Xu, Xu, Ur, Ur, Uu, Rr, Xoym, Uu, Xu, Xu, Uu, Uu, Xu, Xu, Xu
Xu, Xu, Xu, Xu, Uu^Em, Ur^Em, Ur^Em, Uh, Uu^Em, Xu, Xu, Xu, Xu, Ur^Edt, Ur^Edt, Uu^Edt, Uu^Edt, Uu^Vu, Xu, Xu, Xu, Rb^Em, Xu, Wwg^Bw\r, Wwg^Bw\r, Rb^Em, Uh, Xu, Xu, Xu, Xu, Ur, Uu, Rr, Rr, Xu, Uu, Uu, Uu, Xu, Xu, Xu
Xu, Xu, Xu, Xu, Uh, Uu^Em, Uu^Uf, Ur^Em, Uu^Uf, Uu^Uf, Uu^Uf, Xu, Qxu, Qxu, Xu, Ur^Edt, Uu^Edt, Xu, Xu, Xu, Uu^Em, Rb^Em, Xu, Xu, Xu, Rb, Xu, Xu, Xu, Xu, Xu, Xu, Uu, Rr, Rr, Uu, Xu, Uu, Xu, Xu, Xu, Xu
Xu, Xu, Xu, Uu^Uf, Uh, Uh, Xu, Ur^Em, Uu^Uf, Uu^Uf, Ur^Uf, Uu^Uf, Uu^Em, Qxu, Xu, Xu, Xu, Xu, Rb^Em, Rb^Es, Rb, Rb^Em, Xu, Xu, Rb, Wwf, Xu, Xu, Xu, Xu, Uh, Uu, Uu, Rr, Uu, Xu, Xu, Xu, Xu, Xu, Xu, Xu
Xu, Xu, Xu, Xu, Xu, Xu, Xu, Ur^Em, Ur^Em, Ur^Em, Uu^Em, Ur^Em, Ur^Em, Re, Re^Es, Xu, Cay, Xu, Rb^Em, Rb^Em, Xu, Xu, Xu, Xu, Wwg^Bw|r, Xu, Xu, Xu, Uu^Uf, Xu, Xu, Xu, Xu, Uu^Uf, Wwg^Uf, Xuc, Rb^Em, Xuc, Xuc, Xu, Xu, Xu
Xu, Xu, Xu, Xu, Xu, Xu, Xu, Xu, Xu, Xu, Xu, Uu^Em, Uu^Uf, Re^Es, Re, Re, Re, Re, Re, Xu, Xu, Xu, Wog, Wwg, Wwg^Bw\r, Xu, Xuc, Xu, Rb^Uf, Rb^Uf, Rb, Xu, Xu, Uu^Uf, Uu^Vu, Wwrg, Xuc, Rb^Uf, Xuc, Xu, Xu, Xu
Xu, Xu, Xu, Xu, Xu, Xu, Xu, Xu, Xu, Xu, Xu, Xu, Xu, Uu^Vu, Xu, Re^Uf, Cay, Re, Xu, Xu, Xu, Xu, Wog, Wog, Wwg, Rb^Em, Rb, Rb, Xu, Xu, Xu, Rb^Edt, Rb, Xu, Xuc, Xuc, Wwrg, Rb^Em, Xu, Xu, Xu, Xu
Xu, Xu, Xu, Xu, Xu, Xu, Xu, Xu, Xu, Xu, Xu, Xu, Xu, Xu, Xu, Xu, Xos, Xu, Xu, Xu, Uu^Uf, Wog, Wog, Wog, Xu, Xu, Uu^Vu, Xu, Xu, Xu, Xu, Xu, Wwf, Wwf, Wwg, Wwf, Xu, Xu, Xu, Xu, Xu, Xu
Xu, Xu, Xu, Xu, Xu, Xu, Xu, Xu, Xu, Xu, Xu, Xu, Xu, Xu, Xu, Xu, Xu, Xu, Xu, Xu, Xu, Wog, Wog, Xu, Xu, Xu, Xu, Xu, Xu, Xu, Xu, Xu, Xu, Xu, Xu, Xu, Xu, Xu, Xu, Xu, Xu, Xu
