Xos, Xos, Xos, Xos, Xos, Xos, Xos, Xos, Xos, Xos, Xos, Xos, Xos, Xos, Xos, Xos, Xos, Xos, Xos, Xos, Xos, Xos
Xos, Xos, Xos^Efs, Xos^Efs, Urb, Xos, Xos^Efs, Xos, Xos, Xos, Xos, Xos, Xos, Xos, Xos, Xos, Xos, Xos, Xos, Xos, Xos, Xos
Xos, Xos, Chr, Urb, 2 Khr, Urb, Chr, Xos, Chr, Xos, Uu, Xos, Xos, Xos, Xuc, Xos, Uu, Xos, Uh, Xos, Xos, Xos
Xos, Xos, Urb, Chr, Chr, Chr, Chr, Urb, Xot, Uu, Tb^Tf, Uu, Uu, Uu, Uu, Uu, Xos, Uu, Uh, Uh, Xos, Xos
Xos, Xos, Xos, Chr, Urb, Chr, Xot^Edb, Xot^Edb, Urb, Xot^Edb, Xot^Edb, Urb, Xot^Efs, Xot, Xot, Xos, Uu^Vu, Xos, Xos, Uu, Xos, Xos
Xos, Xos, Uu, Chr, Xos, Xot^Efs, Urb^Edb, Urb, Xos, Urb, Urb, Urb, Urb, Uu, Uu, Xos, Uu, Xuc, Uu, Uu, Xos, Xos
Xos, Uu, Xot^Efs, Xos, Xuc, Uu^Edb, Uu^Edb, Xot^Efs, Uu^Vud, Xos, Xos, Xos, Xos, Rb, Uu, Xos, Uu, Uu, Uu^Edb, Uu^Dr, Uu^Edb, Xuc
Xos, Uu, Uu^Edb, Uu^Edb, Uu^Edb, Urb^Edb, Xos, Uu^Edb, Uu, Xot^Edb, Xot^Edb, Uu^Vu, Uu, Xos, Rr, Xot, Xot, Xos, Uu^Edb, Uu^Edb, Uu^Edb, Xuc
Xos, Xos, Uh, Xot, Uu^Edb, Uu^Edb, Rb, Xuc, Uh, Urb, Uu, Xuc, Uu, Xos, Rr, Uu, Uu, Xot, Uu^Edb, Uu^Edb, Uu^Edb, Xuc
Xos, Xos, Uh, Xot, Uu^Edb, Uu^Edb, Xuc, Re, Uu, Ql, Uu, Xos, Xuc, Uu, Qxu, Uu, Rb, Xot, Uu, Tb^Tf, Tb^Tf, Xuc
Xos, Xos, Uh, Xot^Efs, Uu, Xos, Uu^Vu, Xos, Uu, Xuc, Tb^Tf, Xos, Uu, Tb^Tf, Xu, Uu, Ur, Uu, Uu, Tb^Tf, Uu, Xuc
Xu, Xuc, Xuc, Urb, Uu, Xos, Uu, Xos, Ur, Xos, Uu, Uu, Qxu, Uu, Xu, Xu, Ur, Xu, Uu, Uh, Uu, Xuc
Xu, Xu, Tb^Tf, Xuc, Uu^Edb, Xuc, Uu^Edb, Xuc, Rb, Qxu, Qxu, Rb, Xu, Uu^Vu, Xu, Xuc, Uu, Xu, Uu, Uh, Uu, Xu
Xu, Xu, Xu, Uu^Edb, Uu^Edb, Xuc, Uu^Edb, Uh, Ur, Uu, Uu, Ur, Xuc, Xu, Ur, Rb, Xu, Xu, Uu, Uu, Uu, Xu
Xu, Xu, Xu, Uh^Edb, Uu^Edb, Uu^Edb, Uu, Xu, Uu, Xu, Xu, Uu, Ur, Xuc, Uu, Xuc, Uu, Xu, Uu, Uu, Xu, Xu
Xu, Xu, Qxu, Qxu, Xu, Xu, Uu, Xu, Ur, Tb^Tf, Xu, Xu, Uu^Vu, Ur, Xu, Uu, Uu, Xu, Xuc, Uu, Xu, Xu
Xu, Uu, Uu, Qxu, Uu^Vu, Uu, Xu, Ql, Uu, Xu, Xuc, Xu, Xu, Xu, Xu, Uu, Xuc, Xu, Uu, Uu, Xu, Xu
Xu, Uu, Tb^Tf, Qxu, Xu, Uu, Uu, Uu, Uu^Edt, Uu, Rb, Uu, Uu^Dr, Xuc, Uu, Uu, Uu, Uu, Xu, Xu, Xu, Xu
Xu, Xu, Uu, Xuc, Uu, Uu, Xu, Xu, Uu^Edt, Uu^Edt, Xu, Rb, Ur, Uu, Uu, Xu, Xu, Xu, Tb^Tf, Uu^Vu, Xu, Xu
Xu, Xu, Xu, Uu, Uh, Xu, Uu^Edt, Uu^Edt, Uh^Edt, Uu^Edt, Uu^Edt, Xu, Xu, Ur, Ur, Uu, Uu, Uu, Uu, Uu, Xu, Xu
Xu, Xu, Xu, Xu, Xu, Uu^Edt, Uu^Edt, Uu^Edt, Uu^Edt, Uu^Edt, Xu, Uu, Uu^Vu, Xu, Xu, Ur, Ur, Uu, Rr, 1 Uu, Uu, Xu
Xu, Xu, Xu, Xu, Xu, Xu, Xu, Xu, Xu, Xu, Xu, Xu, Xu, Xu, Xu, Xu, Xu, Xu, Xu, Xu, Xu, Xu
