Xos, Xos, Xos, Xos, Xos, Xos, Xos, Xos, Xos, Xos, Xos, Xos, Xos, Xos, Xos, Xos, Xos, Xos, Xos, Xos, Xos, Xos
Xos, Xos, Xos, Xos, Urb, Xos, Xos, Xos, Xos, Xos, Xos, Xos, Xos, Xos, Xos, Xos, Xos, Xos, Xos, Xos, Xos, Xos
Xos, Xos, Chr, Urb, 2 Khr, Urb, Chr, Xos, Chr, Xos, Uu, Xos, Xos, Xos, Xos, Xos, Uu, Xos, Uh, Xos, Xos, Xos
Xos, Xos, Urb, Chr, Chr, Chr, Chr, Urb, Xos, Uu, Uu^Uf, Uu, Uu, Uu, Uu, Uu, Xos, Uu, Uh, Uh, Xos, Xos
Xos, Xos, Xos, Chr, Urb, Chr, Xos, Xos, Uu, Xos, Xos, Uu, Xos, Xos, Xos, Xos, Uu^Vu, Xos, Xos, Uu, Xos, Xos
Xos, Xos, Uu, Chr, Xos, Xos, Urb^Edb, Urb, Xos, Urb, Uu, Uu, Urb, Uu, Uu, Xos, Uu, Xos, Uu, Uu, Xos, Xos
Xos, Uu, Xos, Xos, Xos, Uu^Edb, Uu^Edb, Xos, Uu^Vud, Xos, Xos, Xos, Xos, Urb, Uu, Xos, Uu, Uu, Uu^Edb, Uu^Dr, Uu^Edb, Xuc
Xos, Uu, Uu^Edb, Uu^Edb, Uu^Edb, Urb^Edb, Xos, Uu^Edb, Uu, Xos, Xos, Uu^Vu, Uu, Xos, Urb, Xos, Xos, Xos, Uu^Edb, Uu^Edb, Uu^Edb, Xuc
Xos, Xos, Uh, Xos, Uu^Edb, Uu^Edb, Urb^Edb, Xos, Uh, Urb, Uu, Xos, Uu, Xos, Urb, Uu, Uu, Xos, Uu^Edb, Uu^Edb, Uu^Edb, Xuc
Xos, Xos, Uh, Xos, Uu^Edb, Uu^Edb, Xuc, Urb, Uu, Ql, Uu, Xos, Xos, Uu, Xu, Uu, Urb, Xos, Uu, Uu^Uf, Uu^Uf, Xuc
Xos, Xos, Uh, Xos, Uu, Xuc, Uu^Vu, Xuc, Uu, Xuc, Uu^Uf, Xos, Uu, Uu^Uf, Xu, Uu, Urb, Uu, Uu, Uu^Uf, Uu, Xuc
Xu, Xuc, Xuc, Uu, Uu, Xuc, Uu, Xuc, Urb, Xuc, Uu, Uu, Xu, Uu, Xu, Xu, Urb, Xu, Uu, Uh, Uu, Xuc
Xu, Xu, Uu^Uf, Xuc, Uu^Edb, Xuc, Uu^Edb, Xuc, Urb, Xuc, Xuc, Urb, Xu, Uu^Vu, Xu, Xu, Uu, Xu, Uu, Uh, Uu, Xu
Xu, Xu, Xu, Uu^Edb, Uu^Edb, Xuc, Uu^Edb, Uh, Urb, Uu, Uu, Urb, Xu, Xu, Urb, Urb, Xu, Xu, Uu, Uu, Uu, Xu
Xu, Xu, Xu, Uh^Edb, Uu^Edb, Uu^Edb, Uu, Xu, Uu, Xu, Xu, Uu, Urb, Xu, Uu, Xu, Uu, Xu, Uu, Uu, Xu, Xu
Xu, Xu, Uu, Xu, Xu, Xu, Uu, Xu, Urb, Uu^Uf, Xu, Xu, Uu^Vu, Urb, Xu, Uu, Uu, Xu, Xu, Uu, Xu, Xu
Xu, Uu, Uu, Xu, Uu^Vu, Uu, Xu, Ql, Uu, Xu, Xu, Xu, Xu, Xu, Xu, Uu, Xu, Xu, Uu, Uu, Xu, Xu
Xu, Uu, Uu^Uf, Xu, Xu, Uu, Uu, Uu, Uu^Edt, Uu, Urb, Uu, Uu^Dr, Xu, Uu, Uu, Uu, Uu, Xu, Xu, Xu, Xu
Xu, Xu, Uu, Xu, Uu, Uu, Xu, Xu, Uu^Edt, Uu^Edt, Xu, Urb, Urb, Uu, Uu, Xu, Xu, Xu, Uu^Uf, Uu^Vu, Xu, Xu
Xu, Xu, Xu, Uu, Uh, Xu, Uu^Edt, Uu^Edt, Uh^Edt, Uu^Edt, Uu^Edt, Xu, Xu, Urb, Urb, Uu, Uu, Uu, Uu, Uu, Xu, Xu
Xu, Xu, Xu, Xu, Xu, Uu^Edt, Uu^Edt, Uu^Edt, Uu^Edt, Uu^Edt, Xu, Uu, Uu^Vu, Xu, Xu, Urb, Urb, Uu, Rr, 1 Uu, Uu, Xu
Xu, Xu, Xu, Xu, Xu, Xu, Xu, Xu, Xu, Xu, Xu, Xu, Xu, Xu, Xu, Xu, Xu, Xu, Xu, Xu, Xu, Xu
