Xos, Xos, Xos, Xos, Xos, Xos, Xos, Xos, Xos, Xos, Xos, Xos, Xos, Xos, Xos, Xos, Xos, Xos, Xos, Xos, Xos, Xos
Xos, Xos, Xos, Xos, Urb, Xos, Xos, Xos, Xos, Xos, Xos, Xos, Xos, Xos, Xos, Xos, Xos, Xos, Xos, Xos, Xos, Xos
Xos, Xos, Chr, Urb, 2 Khr, Urb, Chr, Xos, Chr, Xos, Uu, Xos, Xos, Xos, Xuc, Xos, Uu, Xos, Uh, Xos, Xos, Xos
Xos, Xos, Urb, Chr, Chr, Chr, Chr, Urb, Xos, Uu, Uu^Uf, Uu, Uu, Uu, Uu, Uu, Xos, Uu, Uh, Uh, Xos, Xos
Xos, Xos, Xos, Chr, Urb, Chr, Xos, Xos, Urb, Xos, Xos, Urb, Xos, Xos, Xos, Xos, Uu^Vu, Xos, Xos, Uu, Xos, Xos
Xos, Xos, Uu, Chr, Xos, Xos, Urb^Edb, Urb, Xos, Urb, Urb, Urb, Urb, Uu, Uu, Xos, Uu, Xuc, Uu, Uu, Xos, Xos
Xos, Uu, Xos, Xos, Xuc, Uu^Edb, Uu^Edb, Xos, Uu^Vud, Xos, Xos, Xos, Xos, Rb, Uu, Xos, Uu, Uu, Uu^Edb, Uu^Dr, Uu^Edb, Xuc
Xos, Uu, Uu^Edb, Uu^Edb, Uu^Edb, Urb^Edb, Xos, Uu^Edb, Uu, Xos, Xos, Uu^Vu, Uu, Xos, Rr, Xos, Xos, Xos, Uu^Edb, Uu^Edb, Uu^Edb, Xuc
Xos, Xos, Uh, Xos, Uu^Edb, Uu^Edb, Rb, Xuc, Uh, Urb, Uu, Xuc, Uu, Xos, Rr, Uu, Uu, Xos, Uu^Edb, Uu^Edb, Uu^Edb, Xuc
Xos, Xos, Uh, Xos, Uu^Edb, Uu^Edb, Xuc, Re, Uu, Ql, Uu, Xos, Xuc, Uu, Qxu, Uu, Rb, Xos, Uu, Uu^Uf, Uu^Uf, Xuc
Xos, Xos, Uh, Xos, Uu, Xos, Uu^Vu, Xos, Uu, Xuc, Uu^Uf, Xos, Uu, Uu^Uf, Xu, Uu, Ur, Uu, Uu, Uu^Uf, Uu, Xuc
Xu, Xuc, Xuc, Uu, Uu, Xos, Uu, Xos, Ur, Xos, Uu, Uu, Qxu, Uu, Xu, Xu, Ur, Xu, Uu, Uh, Uu, Xuc
Xu, Xu, Uu^Uf, Xuc, Uu^Edb, Xuc, Uu^Edb, Xuc, Rb, Qxu, Qxu, Rb, Xu, Uu^Vu, Xu, Xuc, Uu, Xu, Uu, Uh, Uu, Xu
Xu, Xu, Xu, Uu^Edb, Uu^Edb, Xuc, Uu^Edb, Uh, Ur, Uu, Uu, Ur, Xuc, Xu, Ur, Rb, Xu, Xu, Uu, Uu, Uu, Xu
Xu, Xu, Xu, Uh^Edb, Uu^Edb, Uu^Edb, Uu, Xu, Uu, Xu, Xu, Uu, Ur, Xuc, Uu, Xuc, Uu, Xu, Uu, Uu, Xu, Xu
Xu, Xu, Qxu, Qxu, Xu, Xu, Uu, Xu, Ur, Uu^Uf, Xu, Xu, Uu^Vu, Ur, Xu, Uu, Uu, Xu, Xuc, Uu, Xu, Xu
Xu, Uu, Uu, Qxu, Uu^Vu, Uu, Xu, Ql, Uu, Xu, Xuc, Xu, Xu, Xu, Xu, Uu, Xuc, Xu, Uu, Uu, Xu, Xu
Xu, Uu, Uu^Uf, Qxu, Xu, Uu, Uu, Uu, Uu^Edt, Uu, Rb, Uu, Uu^Dr, Xuc, Uu, Uu, Uu, Uu, Xu, Xu, Xu, Xu
Xu, Xu, Uu, Xuc, Uu, Uu, Xu, Xu, Uu^Edt, Uu^Edt, Xu, Rb, Ur, Uu, Uu, Xu, Xu, Xu, Uu^Uf, Uu^Vu, Xu, Xu
Xu, Xu, Xu, Uu, Uh, Xu, Uu^Edt, Uu^Edt, Uh^Edt, Uu^Edt, Uu^Edt, Xu, Xu, Ur, Ur, Uu, Uu, Uu, Uu, Uu, Xu, Xu
Xu, Xu, Xu, Xu, Xu, Uu^Edt, Uu^Edt, Uu^Edt, Uu^Edt, Uu^Edt, Xu, Uu, Uu^Vu, Xu, Xu, Ur, Ur, Uu, Rr, 1 Uu, Uu, Xu
Xu, Xu, Xu, Xu, Xu, Xu, Xu, Xu, Xu, Xu, Xu, Xu, Xu, Xu, Xu, Xu, Xu, Xu, Xu, Xu, Xu, Xu
