Xos, Xos, Xos, Xos, Xos, Xos, Xos, Xos, Xos, Xos, Xos, Xos, Xos, Xos, Xos, Xos, Xos, Xos, Xos, Xos, Xos, Xos
Xos, Xos, Xos, Xos, Xos, Xos, Uh, Xos, Uh, Xos, Ior, Ior, Ior, Xos, Uh, Xos, Xos, Xos, Xos, Xos, Xos, Xos
Xos, Xos, Uh, Uh, Uu, Uh, Re, Uue^Uf, Uue^Uf, Ior, Ior, Ior, Ior, Ior, Uh, Uh, Re, Uh, Xos, Xos, Xos, Xos
Xos, Xos, Uu, Uu, Ds, Ds, Ds, Re, Xos, Ior, Xos, Ior, Ior, Ior, Xos, Re, Ds^Dr, Ds, Ds, Xos, Xos, Xos
Xos, Xos, Uu, Ds, Xos, Ds, Xos, Xos, Xos, Xos, Ior, Xos, Ior, Ior, Xos, Xos, Xos, Xos, Xos, Xos, Xos, Xos
Xos, Uu, Xos, Xos, Xos, Xos, Ior, Ior, Ior, Ior, Ur, Ur, Ur, Xos, Ior, Ior, Re, Ds, Re, Xos, Xu, Xu
Xu, Xos, Xos, Xos, Ior, Ior, Ur, Ds, Rd, Rd, Ds, Ur, Uu, Uu, Uh, Ior, Xu, Re, Uh, Xu, Xu, Xu
Xu, Xu, Xu, Ior, Uue, Uue, Ur, Ur, Re, Ds, Uu, Uh, Uh, Re, Re, Uh, Uh, Xu, Xu, Xu, Uh, Xu
Xu, Xu, Xu, Uu, Uu, Uu, Uh, Ur, Ur, Uu, Uue, Uh, Xu, Ds, Ds, Re, Uue, Uh, Uh, Uh, Uh, Xu
Wog, Xu, Wwg, Rb, Rb, Uh, Uh, Uu, Uu, Ur, Uue^Vu, Xu, Xu, Xu, Ds, Re, Uue, Uh, Uh, Uh, Xu, Xu
Wog, Wog, Wog, Wwg, Wwg, Rb, Uu, Uu, Uu^Uf, Uu, Ur, Ds, Ds, Xu, Ds^Dr, Re, Re, Uue, Uh, Uh, Xu, Xu
Xu, Wog, Wwg, Wwg, Ds, Ds, Ds, Uu^Uf, Uu^Uf, Uu, Ur, Re, Qxu, Ds, Re, Ds, Ds, Re, Uue, Uh, Uh, Xu
Xu, Xu, Rb, Rb, Uu, Ds, Ds, Uh, Ds, Uu, Ur, Qxu, Qxu, Qxu, Uue, Ds, Ds, Re, Uue, Uh, Uh, Xu
Xu, Uh, Uu, Uu, Uu, Uh, Uu, Ds, Uu, Uu, Ur, Qxu, Qxu, Qxu, Ur, Uue, Ds, Uue, Uu, Uu, Uh, Xu
Xu, Uh, Uh, Uu, Uu, Uh, Uu, Uu^Dr, Ur, Ur, Re, Re, Re, Qxu, Uue, Uue, Ds, Uue, Hh, Uh, Uh, Xu
Xu, Xu, Uu, Uh, Uh, Uu, Uu, Uu, Uu, Uue, Re, Ds, Ds, Re, Re, Uue, Ds, Hd, Hd, Hh, Uh, Xu
Xu, Xu, Uh, Uu, Uu, Uu^Vu, Uu, Uh, Uu, Uue, Uue, Re, Ds^Dr, Ds, Ds, Ds, Re, Hd, Hh, Hh, Xu, Xu
Xu, Uh, Uh, Ql, Uh, Uu, Uu, Uu, Uu, Uu^Uf, Uu, Re, Re, Ds, Ds, Ds, Ds, Re, Re, Uh, Xu, Xu
Xu, Xu, Xu, Uh, Uh, Uu^Uf, Uu^Uf, Uu, Uh, Uu, Uu, Uue, Uue, Re, Ds, 1 Dd^Dc, Ds, Ds, Xu, Xu, Xu, Xu
Xu, Xu, Xu, Xu, Xu, Uh, Uh, Uh, Uh, Uu, Uu, Uu, Urb, Re, Ds, Ds, Xu, Xu, Xu, Xu, Xu, Xu
Xu, Xu, Xu, Xu, Xu, Xu, Xu, Uh, Xu, Uh, Xu, Xu, Xu, Xu, Xu, Xu, Xu, Xu, Xu, Xu, Xu, Xu
Xu, Xu, Xu, Xu, Xu, Xu, Xu, Xu, Xu, Xu, Xu, Xu, Xu, Xu, Xu, Xu, Xu, Xu, Xu, Xu, Xu, Xu
