Xos, Xos, Xos, Xos, Xos, Xos, Xos, Xos, Xos, Xos, Xoi, Xoi, Xoi, Xos, Xos, Xos, Xos, Xos, Xos, Xos, Xos, Xos
Xos, Xos, Xos, Xos, Xos, Xos, Uh, Xos, Uh, Xom, Ior, Ior, Ior, Xom, Uh, Xos, Xos, Xos, Xos, Xos, Xos, Xos
Xos, Xos, Uh, Uh, Uu, Uh, Re, Uue^Uf, Uue^Uf, Ior, Ior, Ior, Ior, Ior, Uh, Uh, Re, Uh, Xos, Xos, Xos, Xos
Xos, Xos, Uu, Uu, Ds, Ds, Ds, Re, Xos, Ior, Xos, Ior, Ior, Ior, Xos, Re, Ds^Dr, Ds, Ds, Xos, Xos, Xos
Xos, Xos, Uu, Ds, Xos, Ds, Xos, Xos, Xos, Xos, Ior, Xos, Ior^Pwdo, Ior, Xos, Xos, Xos, Xos, Xos, Xos, Xos, Xos
Xos, Uu, Xos, Xos, Xos, Xos, Ior, Ior, Ior, Ior, Ur^Esd, Ur, Ur, Xos, Ior, Ior, Re, Ds, Re, Xos, Xu, Xu
Xu, Xos, Xos, Xos, Ior, Ior, Ur, Ds^Esd, Rd, Rd, Ds, Ur, Uu, Uu, Uh, Ior, Xu, Re, Uh, Xu, Xu, Xu
Xu, Xu, Xuc, Ior, Uu^Em, Uu^Em, Ur^Em, Ur, Re^Es, Ds^Es, Uu, Uh, Uh, Re, Re, Uh, Uh, Xu, Xu, Xu, Qlf, Xu
Xuc, Xu, Xuc, Uu^Em, Uu^Em, Ur^Em, Uh, Ur, Ur, Uu^Es, Uu, Uh, Xu, Ds, Ds^Es, Re, Uu, Uh, Uh, Qlf, Qlf, Xu
Wog, Xuc, Wwg, Rb^Em, Rb, Uh, Uh, Uu^Es, Uu, Ur, Uu^Vu, Xu, Xu, Xu, Ds, Re^Es, Uu, Uh, Uh, Uh, Xu, Xu
Wog, Wog, Wog, Wwg, Wwg, Rb, Uu, Uu, Uu^Uf, Uu, Ur^Esd, Ds, Ds, Xu, Ds^Dr, Re, Re^Esd, Uu, Uh, Uh, Xu, Xu
Xu, Wog, Wog, Wwg, Ds, Ds, Ds^Es, Uu^Uf, Uu^Uf, Uu, Ur, Re, Xu, Ds, Re, Ds, Ds, Re, Uu, Uh, Uh, Xu
Xu, Xu, Wog, Rb, Uu, Ds, Ds, Uh, Ds^Es, Uu, Ur, Xu, Qxu, Qxu, Xu, Ds, Ds^Es, Re^Es, Uu, Uh, Uh, Xu
Xu, Uh, Wog, Wwg, Wwg, Uh, Uu, Ds, Ur, Ur, Ur, Xu, Qxu, Qxu, Ur, Uu, Ds, Ur, Uu, Uu, Uh, Xu
Xu, Uh, Uh, Wog, Wog, Uh, Wwg, Uu^Dr, Ur^Es, Ur^Es, Rd^Esd, Rd, Rd, Qxu, Uu, Uu, Ds, Uu, Uh, Uh, Uh, Xu
Xu, Xu, Uu^Em, Uh, Uh, Wwg, Uu, Uu, Uu, Ur, Rd, Ds, Ds, Rd, Rd^Esd, Rd, Ds, Uh, Uh, Uu^Uf, Uu^Uf, Xu
Xu, Xu, Uh, Uu, Ur, Uu^Vu, Ur^Emf, Uh, Uu^Em, Uu^Em, Uu, Rd, Ds^Dr, Ds, Ds, Ds, Re, Uh, Uh, Uu^Uf, Xu, Xu
Xu, Uh, Uh, Ql, Uh, Ur^Em, Uu^Em, Uu^Em, Uu^Em, Uu^Uf, Uu, Re, Re, Ds, Ds, Ds, Ds, Rd, Re, Uh, Xu, Xu
Xu, Xu, Xu, Uh, Uh, Uu^Uf, Uu^Uf, Uu, Uh, Uu^Em, Uu, Uu, Uu, Rd^Esd, Ds, 1 Dd^Dc, Ds, Ds, Xu, Xu, Xu, Xu
Xu, Xu, Xu, Xu, Xu, Uh, Uh, Uh, Uh, Xu, Xu, Uu, Urb, Re, Ds, Ds, Xu, Xu, Xu, Xu, Xu, Xu
Xu, Xu, Xu, Xu, Xu, Xu, Xu, Uh, Xu, Uh, Xu, Xu, Xu, Xu, Xu, Xu, Xu, Xu, Xu, Xu, Xu, Xu
Xu, Xu, Xu, Xu, Xu, Xu, Xu, Xu, Xu, Xu, Xu, Xu, Xu, Xu, Xu, Xu, Xu, Xu, Xu, Xu, Xu, Xu
