Xu, Xu, Xu, Xu, Xu, Xu, Xu, Xu, Xu, Xu, Xu, Xu, Qxu, Qxu, Qxu, Qxu, Qxu, Qxu, Qxu, Qxu, Uu^Em, Qxu, Qxu, Qxu, Qxu, Qxu, Xu, Xu, Xu, Xu, Xu, Xu, Xu, Xu, Xu, Xu, Xu
Xu, Xu, Xu, Xu, Xu, Xu, Xu, Xu, Xu, Xu, Xu, Xu, Xu, Qxu, Qxu, Qxu, Qxu, Qxu^Bcx\, Qxu, Qxu, Qxu, Qxu, Qxu, Qxu, Qxu, Qxu, Xu, Xu, Xu, Xu, Xu, Xu, Xu, Xu, Xu, Xu, Xu
Xu, Xu, Xu, Xu, Xu, Xu, Xu, Xu, Xu, Xu, Xu, Xu, Xu, Xu, Xu, Qxu, Qxu, Qxu, Qxu, Qxu^Bcx\, Ias, Qxu, Qxu, Qxu, Uu, Tb^Tf, Uu^Tf, Xu, Uu^Tf, Xu, Xu, Xu, Xu, Xu, Xu, Xu, Xu
Xu, Xu, Xu, Xu, Xu, Xu, Xu, Xu, Xu, Xu, Xu, Uu^Tf, Uu^Em, Tb^Tf, Uu^Em, Uu^Tf, Uu^Em, Uu, Uu, Ias, Uu, Ias, Uu, Uu, Ur, Ur, Ur, Ur, Ur, Tb^Tf, Uu^Tf, Xu, Xu, Xu, Xu, Xu, Xu
Xu, Xu, Xu, Xu, Xu, Xu, Xu, Xu, Uu, Qxu, Uu, Uu, Uu, Uu, Uu, Uu, Xu, Uu, Uu, Uu, Ur^Em, Rb, Ur, Ur, Uu, Ur, Urb, Ur^Em, Ur, Uu, Uu, Uu^Tf, Uu^Tf, Xu, Xu, Xu, Xu
Xu, Xu, Xu, Xu, Xu, Xu, Uu, Uu, Ur, Uu, Uh, Xu, Xu, Xu, Xoa, Xu, Xoa, Xoa, Rb, Rb, Ur, Ur, Xu, Xuc, Uu, Urb, Rb^Em, Urb, Uu, Ur, Ur, Uu^Em, Wwf, Xu, Xu, Xu, Xu
Xu, Xu, Xu, Xu, Uu^Tf, Uu, Uu, Uu, Uu, Ur, Ur, Xu, Ur, Uu, Ias, Ias, Ias, Ias, Ias, Ias, Uu^Tf, Uu, Xu, Xu, Uu, Uu^Em, Uu, Uu, Xuc, Uu, Ur, Uu, Uu^Tf, Xu, Xu, Xu, Xu
Xu, Xu, Xu, Xu, Uu^Em, Uu, Uu, Uu, Xu, Xu, Uu, Ur, Uu, Ias, Ias, Ias, Ias, Ias, Ias^Tf, Tb^Tf, Tb^Tf, Xu, Xu, Xu, Uu, Uu^Vu, Uu, Uu, Xu, Uu, Ur, Ur^Em, Sm^Em, Sm^Em, Tb, Xu, Xu
Xu, Xu, Xu, Uu^Tf, Ur, Uu, Uh, Xu, Xu, Xu, Uu, Xu, Ur, Ur, Rb, Rb, Rb, Ias^Em, Uu^Tf, Uu^Tf, Uu^Tf, Xu, Xu, Xu, Xu, Uu, Xu, Xu, Xu, Xuc, Ur, Wwf, Wwf, Sm, Xu, Xu, Xu
Xu, Xu, Tb^Tf, Uu, Ur, Uu, Xu, Xu, Xu, Uh, Uu, Uu, Ur, Xu, Rb, Uu, Uu, Rb^Em, Rb^Em, Uu^Tf, Uu^Em, Uu^Em, Xu, Xu, Xu, Xu, Xu, Xu, Xu, Xu, Ur, Ur, Uu, Xu, Xu, Xu, Xu
Xu, Xu, Uu, Ur, Ur, Uu, Xu, Xu, Xu, Uu, Ur, Ur, Uu, Xu, Uu, Xu, Tb^Tf, Uu, Ur, Rb^Em, Rb, Uu, Uu, Uh, Xuc, Uh, Uu, Xu, Xu, Xuc, Ur, Ur^Es, Uu, Xu, Xu, Xu, Xu
Xu, Xu, Uu, Uu, Ur, Uh, Xu, Xu, Uh, Uu, Ur, Uu, Xu, Xu, Xu, Xu, Xu, Uu, Uu, Ur, Rb, Ias, Uu, Uu, Uu, Uu, Uu^Em, Uu, Xu, Xu, Uu, Ur, Uu, Xu, Xu, Xu, Xu
Xu, Uu^Tf, Tb^Tf, Ur, Ur, Xu, Xu, Xu, Uu, Uu^Dr, Ur, Uu, Xu, Xu, Xu, Qxu, Xuc, Uu, Uu, Ur, Ias, Ias, Xoa, Xu, Xu, Uu, Ur, Uu, Uu, Xu, Uu, Ur^Es, Uu, Xu, Xu, Xu, Xu
Xu, Tb^Tf, Uu^Tf, Ur, Ur, Xu, Xu, Uh, Rb, Rb, Uu, Xu, Xu, Xu, Xuc, Uu, Ur, Uu, Uu, Uu, Ias, Ias, Ias, Uu, Uu, Xu, Uu, Ur^Es, Ur, Ur, Ur, Ur, Ur, Uh, Xu, Xu, Xu
Xu, Tb^Tf, Uu, Uu, Urb, Xuc, Rb, Rb^Em, Uu, Uu, Xu, Xu, Xu, Xu, Xu, Ur, Uu, Xoa, Xoa, Uu, Rb, Rb, Uu, Uu, Uu, Uu, Xu, Uu, Uu, Uu, Uu, Uu^Em, Ur^Em, Uu, Xu, Xu, Xu
Xu, Xu, Ur, Ur, Xuc, Urb, Uu, Uu, Uu, Uu, Xu, Xu, Xu, Xu, Xoa, Ur, Ur, Uu, Xoa, Uu, Rb, Uu^Dr, Uu, Xoa, Xoa, Xu, Xu, Xu, Xu, Xu, Xuc, Uu, Wwf, Sm, Uh, Xu, Xu
Xu, Xu, Ur, Xu, Xu, Uu, Uu, Uu, Xuc, Xu, Xuc, Xu, Xoa, Xoa, Xoa, Xoa, Ias, Ias, Cpy, Ias, Ias, Uu, Uu, Xoa, Xoa, Xu, Xu, Xu, Xu, Xu, Ur, Ur, Sm^Tf, Sm^Tf, Tb^Tf, Xu, Xu
Xu, Xu, Ur, Xu, Tb^Tf, Uu^Em, Xu, Rb, Rb, Uh, Uh, Uu, Uu, Ias^Em, Ias, Ias, Ias, Ias, Mybd, Ias, Ias, Uu, Uu^Tf, Uu, Xoa, Xoa, Xoa, Xu, Uu, Uu, Ur^Em, Uu^Tf, Uu^Tf, Tb^Tf, Tb^Tf, Xu, Xu
Xu, Xu, Ur, Uu^Em, Xu, Uu^Em, Xu, Xu, Xuc, Uu, Uu, Xoa, Ias, Uu, Ias, Ias, Mybd^Es, Mybd, Myb, Mybd, Mybd, Ias, Ias, Ias, Uu, Uh, Xoa, Uu, Ur, Ur^Es, Ur, Uu^Tf, Wwf^Em, Sm^Tf, Uu^Tf, Xu, Xu
Xu, Xu, Uu, Ur, Uu, Uu, Xuc, Xu, Xu, Uu, Xu, Xoa, Ias, Ias, Cay, Mybd, Myb, Myb, Myb, Myb, Myb, Mybd, Cay, Uu, Xoa, Uu, Uu^Tf, Ur, Uu, Uu, Xu, Ur, Ur, Wwf, Sm, Xu, Xu
Xu, Xu, Uu, Ur, Ur, Uu, Xuc, Xu, Xuc, Ur, Ur, Ias, Ias, Xoa, Ias, Mybd, Mybd, Myb, Myb, Myb, Mybd, Mybd, Ias, Uu, Xoa, Ias, Uu, Xu, Xu, Xu, Xu, Xuc, Ur, Sm, Sm, Xu, Xu
Xu, Xu, Xu, Uu, Urb, Urb, Urb, Xuc, Rb, Ur, Uu, Rb, Ias, Xoa, Uu, Ias^Edb, Ias, Mybd, Mybd, Mybd^Es, Ias, Ias, Ias, Ias, Ias, Ias, Uu^Em, Xu, Xu, Xu, Xu, Ur, Sm, Uu, Uh, Xu, Xu
Xu, Xu, Xu, Uu, Uu, Urb, Uu, Rb, Xu, Ur, Xu, Xoa, Ias, Uu^Tf, Xoa, Xoa, Uu, Ias, Ias, Ias^Edb, Ias, Xoa, Ias, Xoa, Uu, Ias, Uu, Xu, Xu, Xu, Uu, Ur, Uu, Uu, Xu, Xu, Xu
Xu, Xu, Xu, Xu, Uu, Ur, Uu, Xu, Xu, Ur, Xoa, Xoa, Ias, Uu, Xoa, Uu^Vu, Xoa, Xoa, Uh, Ias, Uu, Xoa, Xoa, Xoa, Rb, Ias, Uu, Xu, Xu, Xu, Ur, Ur, Uu, Uh, Xu, Xu, Xu
Xu, Xu, Xu, Uu, Uh, Ur, Ur, Uu, Xu, Uu, Ias, Ias, Ias, Xoa, Xos, Uu, Xoa, Uu, Uh, Ias, Xu, Ias, Xu, Xoa, Urb, Uh, Uh, Xu, Xu, Uu, Ur, Uu, Uh, Xu, Xu, Xu, Xu
Xu, Xu, Xu, Uu, Uu, Uu, Ur, Uu, Xu, Uu^Tf, Uu, Ias^Es, Ias, Xoa, Xu, Uu, Uu, Uu, Urb, Xu, Uu^Vu, Uu, Xu, Xu, Ur, Uh, Uu, Xuc, Ur, Ur, Uu, Uu, Xu, Xu, Xu, Xu, Xu
Xu, Xu, Xu, Uu^Em, Uu^Tf, Uu, Ur, Xu, Xu, Uu, Uu^Dr, Ias, Xu, Uh, Uh, Xu, Urb, Xu, Xu, Xu, Xu, Rb, Xu, Xuc, Ur, Ur^Es, Uu, Ur, Ur, Ur, Uu, Uu, Xu, Xu, Xu, Xu, Xu
Xu, Xu, Xu, Tb^Tf, Uu^Em, Uh, Ur, Xu, Xu, Uu, Uu^Es, Ias, Xu, Uh, Uh, Xuc, Urb, Xu, Xu, Urb, Urb, Xu, Xu, Xu, Uu, Ur, Ur, Ur, Uu, Uu, Xu, Xu, Xu, Xu, Xu, Xu, Xu
Xu, Xu, Xu, Xu, Uu, Uu, Ur, Xu, Xuc, Ur, Uu, 1 Uu, Rb, Xu, Xu, Uu, Urb, Xu, Rb, Uu, Xu, Xu, Xu, Uu, Ur, Ur^Es, Uu, Uu, Uu, Uu, Xu, Xu, Xu, Xu, Xu, Xu, Xu
Xu, Xu, Xu, Xu, Uu, Uu, Uu, Ur, Ur, Rb, Uu, Uh, Uu, Uu, Xu, Uu, Xu, Xu, Xu, Uu, Ur, Ur, Uu^Edb, Rb, Rb, Uu, Uh, Xu, Xu, Xu, Xu, Xu, Xu, Xu, Xu, Xu, Xu
Xu, Xu, Xu, Xu, Xu, Uu, Uu, Uu^Dr, Uu, Ur, Xu, Xu, Uh, Uu, Urb^Es, Urb, Xu, Uu, Urb, Urb, Uu^Edb, Uu^Edb, Uu^Edb, Uu, Uu, Uu^Tf, Xu, Xu, Xu, Xu, Xu, Xu, Xu, Xu, Xu, Xu, Xu
Xu, Xu, Xu, Xu, Xu, Uu, Uu, Uu, Uu, Ur, Urb, Urb, Uh, Uu, Urb, Rb, Uu, Urb, Urb, Xu, Xu, Uu^Edb, Uu^Edb, Uu^Edb, Uu, Xu, Xu, Xu, Xu, Xu, Xu, Xu, Xu, Xu, Xu, Xu, Xu
Xu, Xu, Xu, Xu, Xu, Xu, Xu, Uu^Tf, Xu, Xu, Uu, Urb, Urb, Xu, Xu, Rb, Uh, Urb, Xu, Rb, Xu, Uu, Uu, Uh, Xu, Xu, Xu, Xu, Xu, Xu, Xu, Xu, Xu, Xu, Xu, Xu, Xu
Xu, Xu, Xu, Xu, Xu, Xu, Xu, Xu, Xu, Xu, Uu, Uu, Uu, Rb, Xu, Rb, Rb, Urb, Rb, Rb, Uu, Uu, Uh, Xu, Xu, Xu, Xu, Xu, Xu, Xu, Xu, Xu, Xu, Xu, Xu, Xu, Xu
Xu, Xu, Xu, Xu, Xu, Xu, Xu, Xu, Xu, Xu, Uh, Uh, Uu, Rb, Cer, Cer, Cer, Cer, Cer, Xu, Tb^Tf, Xu, Xu, Xu, Xu, Xu, Xu, Xu, Xu, Xu, Xu, Xu, Xu, Xu, Xu, Xu, Xu
Xu, Xu, Xu, Xu, Xu, Xu, Xu, Xu, Xu, Xu, Xu, Xu, Xu, Xu, Tb^Tf, Cer, 2 Ker, Cer, Xu, Xu, Xu, Xu, Xu, Xu, Xu, Xu, Xu, Xu, Xu, Xu, Xu, Xu, Xu, Xu, Xu, Xu, Xu
Xu, Xu, Xu, Xu, Xu, Xu, Xu, Xu, Xu, Xu, Xu, Xu, Xu, Xu, Xu, Xu, Uu, Uu, Xu, Xu, Xu, Xu, Xu, Xu, Xu, Xu, Xu, Xu, Xu, Xu, Xu, Xu, Xu, Xu, Xu, Xu, Xu
