Xoc, Xoc, Xoc, Xoc, Xoc, Xoc, Xoc, Xoc, Xoc, Xoc, Xoc, Xoc, Xoc, Xoc, Xoc
Xoc, Xoc, Xoc, Xoc, Xoc, Xoc, Xoc, Icr, Xoc, Xoc, Xoc, Xoc, Xoc, Xoc, Xoc
Xoc, Xoc, Irs, Irs, Xoc^Efs, Xoc, Xoc, Icr, Xoc, Xoc, Xoc^Efs, Irs, Irs, Xoc, Xoc
Xoc, Xoc, Irs, Irs, Irs, Irs, Icr, 3 Icr, Icr, Irs, Irs, Irs, Irs, Xoc, Xoc
Xoc, Xoc, Irs, Irs, Irs, Irs, Icr, Icr, Icr, Irs, Irs, Irs, Irs, Xoc, Xoc
Xoc, Xoc, Irs, Irs, 4 Irs, Irs, Icr, Icr, Icr, Irs, Irs, Irs, Irs, Xoc, Xoc
Xoc, Xoc, Irs^Ebn, Irs, Irs, Irs, 1 Icr, Icr, 2 Icr, Irs, Irs, Irs, Irs^Ebn, Xoc, Xoc
Xoc, Xoc, Xoc, Irs, Irs, Irs, Icr, Icr, Icr, Irs, Irs, Irs, Xoc, Xoc, Xoc
Xoc, Xoc, Xoc, Xoc, Xoc, Irs, Irs, Icr, Irs, Irs, Xoc, Xoc, Xoc, Xoc, Xoc
Xoc, Xoc, Xoc, Xoc, Xoc, Xoc, Irs, Irs, Irs, Xoc, Xoc, Xoc, Xoc, Xoc, Xoc
Xoc, Xoc, Xoc, Xoc, Xoc, Xoc, Irs, Irs, Irs, Xoc, Xoc, Xoc, Xoc, Xoc, Xoc
Xoc, Xoc, Xoc, Xoc, Xoc, Xoc, Irs, Irs, Irs, Xoc, Xoc, Xoc, Xoc, Xoc, Xoc
