border_size=1
usage=map

Aa^Fpa      , Aa^Fpa      , Aa^Fpa      , Aa^Fpa      , Aa^Fpa      , Aa          , Aa          , Aa          , Aa          , Aa          , Aa          , Aa          , Aa          , Aa          , Aa^Fpa      , Aa^Fpa      , Aa^Fpa      , Aa          , Aa^Fpa      , Aa^Fpa      
Aa^Fpa      , Aa^Fpa      , Aa^Fpa      , Aa^Fpa      , Aa^Fpa      , Aa^Fpa      , Aa          , Aa          , Aa          , Aa          , Aa          , Aa          , Aa          , Aa          , Aa          , Aa^Fpa      , Aa          , Aa          , Aa^Fpa      , Aa^Fpa      
Aa^Fpa      , Aa^Fpa      , Aa^Fpa      , Aa^Fpa      , Aa^Fpa      , Aa^Fpa      , Gg          , Gg          , Gd^Vhr      , Gg          , Rb          , Ai          , Ai          , Aa          , Aa          , Aa          , Aa          , Aa^Fpa      , Aa^Fpa      , Aa^Fpa      
Aa^Fpa      , Aa^Fpa      , Aa^Fpa      , Gll^Fp      , Gll^Fp      , Gll^Fp      , Gll^Fp      , Gg          , Gg          , Gg          , Rb          , Ai          , Ai          , Ai          , Rb          , Aa          , Gg          , Aa^Fpa      , Aa^Fpa      , Aa^Fpa      
Aa          , Aa^Fpa      , Gll^Fp      , Gll^Fp      , Gll^Fp      , Gll^Fp      , Gg          , Gg          , Gg          , Rb          , Rb          , Rb          , Rb          , Rb          , Rb          , Gg          , Gg          , Aa^Fpa      , Aa^Fpa      , Aa^Fpa      
Gg          , Aa          , Gg          , Gg          , Gll^Fp      , Gll^Fp      , Gll^Fp      , Gg          , Gll         , Gg          , Gg          , Gg          , Gg          , Gg          , Gg          , Gg          , Gg          , Aa          , Aa          , Aa          
Gg          , Gg          , Gg          , Gg          , Gg          , Gg          , Gg          , Gg          , Gg          , Gg          , Re^Eff      , Re^Eff      , Re^Eff      , Gll         , Gg          , Gg          , Gg          , Aa          , Aa          , Aa          
Aa          , Gg          , Gg          , Gg          , Gg          , Gg          , Gg          , Gg          , Re^Eff      , Re^Eff      , Re^Gvs      , Gs^Vc       , Re^Gvs      , Re^Eff      , Re^Eff      , Gg          , Re          , Gll         , Aa          , Aa          
Aa          , Aa          , Aa          , Aa          , Gg          , Gg          , Re^Eff      , Re^Eff      , Re^Gvs      , Re^Gvs      , Re^Gvs      , Re^Gvs      , Re^Gvs      , Re^Gvs      , Re^Gvs      , Re^Eff      , Re^Eff      , Gll         , Gll         , Aa          
Aa^Fpa      , Aa^Fpa      , Aa^Fpa      , Aa          , Aa          , Gg          , Gg          , Re^Eff      , Re^Eff      , Re^Gvs      , Re^Gvs      , Re^Gvs      , Re^Gvs      , Re^Gvs      , Re^Gvs      , Re^Gvs      , Re^Eff      , Re^Eff      , Gll         , Aa          
Aa^Fpa      , Aa^Fpa      , Aa^Fpa      , Aa          , Gll         , Gll         , Gg          , Gg          , Gg          , Rp          , Re^Eff      , Re^Gvs      , Re^Gvs      , Re^Gvs      , Re^Eff      , Re^Eff      , Gll         , Gll         , Aa          , Aa          
Aa^Fpa      , Aa^Fpa      , Aa          , Aa          , Gll         , Gll         , Gg          , Ce          , Rp          , Rp          , Gll         , Re^Eff      , Re          , Re^Eff      , Gll         , Gll         , Aa          , Aa          , Aa^Fpa      , Aa^Fpa      
Aa^Fpa      , Aa^Fpa      , Aa          , Gg          , Gg          , Gll         , Gg          , Gg          , Rp          , Gll         , Gll         , Gll         , Gll         , Gll         , Rb          , Aa          , Aa          , Aa^Fpa      , Aa^Fpa      , Aa^Fpa      
Aa^Fpa      , Aa^Fpa      , Aa          , Gg          , Gg          , Gg          , Gg          , Gg          , Gs^Vh       , Rp          , Gg          , Gll         , Rb          , Ai          , Ai          , Rb          , Aa          , Aa^Fpa      , Aa^Fpa      , Aa^Fpa      
Aa^Fpa      , Aa^Fpa      , Aa          , Gg          , Gg          , Gd          , Gd          , Gg          , Gg          , Rp          , Rp          , Gg          , Gg          , Rb          , Rb          , Rb          , Aa          , Aa          , Aa          , Aa^Fpa      
Aa          , Aa          , Aa          , Gg          , Gg          , Gd          , Gd          , Gd          , Gg          , Gg          , Gg          , Rp          , Gll         , Gg          , Gll         , Gg          , Gg          , Aa          , Aa          , Aa          
Aa          , Aa          , Aa          , Gg          , Gg          , Gg          , Gg          , Gg          , Gg          , Gg          , Gg          , Rp          , Gll         , Gll         , Gg          , Gll         , Gg          , Rb          , Aa          , Aa          
Aa^Fpa      , Aa          , Aa          , Gg          , Gg          , Gg          , Gg          , Gg          , Gg          , Gg          , Gll         , Rp          , Gll         , Gll         , Gll         , Gll         , Gg          , Aa          , Aa          , Aa          
Aa^Fpa      , Aa^Fpa      , Aa^Fpa      , Aa          , Aa          , Aa          , Aa          , Aa          , Aa          , Aa          , Gll         , Rp          , Gll         , Gll         , Aa          , Aa          , Aa          , Aa          , Aa          , Aa          
Aa^Fpa      , Aa^Fpa      , Aa^Fpa      , Aa^Fpa      , Aa          , Aa          , Aa          , Aa          , Aa          , Gll         , Rp          , Rp          , Gs          , Aa          , Aa          , Aa          , Aa          , Aa          , Aa          , Aa          
