border_size=1
usage=map

Aa^Fpa      , Aa^Fpa      , Aa^Fpa      , Aa^Fpa      , Ha          , Ms          , Ms          , Ms          , Ms          , Ms          , Ha          , Aa          , Aa          , Aa          , Ai          , Ai          , Ai          , Cea         , Cea         , Aa          , Aa          , Aa          
Aa^Fpa      , Aa^Fpa      , Aa^Fpa      , Aa^Fpa      , Aa^Fpa      , Aa          , Ha          , Ha          , Ha          , Ha          , Uh          , Aa          , Aa          , Aa          , Re^Gvs      , Ai          , Re^Gvs      , Re^Gvs      , Ce          , Cea         , Cea         , Aa          
Aa^Fpa      , Aa^Fpa      , Aa^Fpa      , Gs^Fp       , Gs^Fp       , Uh          , Uh          , Uh          , Uh          , Uh          , Uh          , Uh          , Re          , Gg^Vh       , Re^Gvs      , Ww          , Re^Gvs      , Re^Gvs      , Ce          , 2 Ke        , Ce          , Aa          
Aa          , Aa          , Aa^Fpa      , Gs^Fp       , 4 Ke        , Uh          , Uh          , Uu          , Qxu         , Uu          , Uu          , Uu          , Uu          , Re^Gvs      , Ww          , Ww          , Re^Gvs      , Re^Gvs      , Re^Gvs      , Ce          , Re^Gvs      , Cea         
Ha          , Aa          , Aa^Fpa      , Uu          , Uu          , Ce          , Uu          , Uu          , Qxu         , Qxu         , Uu          , Uu          , Ww          , Ww          , Gg^Vh       , Re^Gvs      , Re^Gvs      , Re^Gvs      , Re^Gvs      , Re^Gvs      , Aa          , Cea         
Ha          , Aa          , Aa          , Aa          , Uu          , Uu          , Uu          , Uu^Vu       , Uu          , Uu          , Ww          , Ww          , Uu          , Rb          , Re          , Re^Gvs      , Re^Gvs      , Re^Gvs      , Re^Gvs      , Re^Gvs      , Aa          , Cea         
Aa          , Aa          , Ai          , Aa^Fpa      , Rb          , Uu          , Ql          , Uu          , Uu          , Uu          , Ww^Bw\      , Uu          , Rb          , Rb          , Gs^Fp       , Re          , Re          , Re^Gvs      , Re^Gvs      , Re^Gvs      , Aa          , Cea         
Ce          , Aa          , Ai          , Ai          , Rb          , Uu          , Uu          , Uu          , Ww          , Ww          , Uu          , Uu          , Rb          , Re          , Re          , Re          , Re          , Re          , Re          , Aa          , Cea         , Cea         
Ce          , Gg          , Rb          , Ai          , Ai          , Gs^Fp       , Rb          , Ww          , Uu          , Uu          , Uu          , Rb^Es       , Re          , Re^Gvs      , Re^Gvs      , Re^Gvs      , Gg^Wm       , Re^Gvs      , Re^Gvs      , Rp          , Cea         , Aa          
Ce          , Gg          , Rp          , Rb          , Ai          , Ai          , Ai          , Ww          , Uu          , Ql          , Uu          , Rb          , Gs          , Re^Gvs      , Re^Gvs      , Re^Gvs      , Re^Gvs      , Re^Gvs      , Rp          , Ce          , Gg          , Aa          
Ce          , Gg          , 3 Ke        , Cea         , Rb          , Ai          , Rb          , Ww          , Uu          , Uu          , Rb          , Gg^Vh       , Re          , Re^Gvs      , Gg^Fet      , Re          , Rp          , Rp          , Ce          , Ce          , Gg          , Aa          
Ce          , Gg          , Gg          , Gg^Fet      , Gg^Vh       , Rb          , Ww          , Ww^Bw\      , Rb          , Rb          , Rb          , Re          , Re          , Re          , Gg^Vh       , Rp          , Rp          , Ce          , Gg          , Gg          , Aa          , Aa          
Ce          , Gg          , Ww          , Gg          , Ww          , Ww          , Rb          , Rb          , Rr          , Rr          , Rp          , Gg^Vh       , Gs          , Gs          , Rp          , Rp          , Ce          , Ce          , Gg          , Aa          , Aa^Fpa      , Gs^Fp       
Cea         , Gg          , Ww          , Ww          , Ww          , Gg          , Rp          , Rp          , Rr          , Ai          , Rr          , Re          , Re          , Rp          , Rp          , Ce          , Ce          , Gg          , Gg          , Gg          , Gs^Fp       , Gs^Fp       
Cea         , Aa          , Ai          , Ww          , Ww          , Gg          , Rp^Es       , Rp          , Rr          , Rr          , Gg^Vh       , Rr          , Rr          , Gs^Fp       , Rr          , Rr          , Rr          , Gg          , Gg          , Gg          , Gs^Fp       , Gs^Fp       
Cea         , Aa          , Aa          , Ai          , Gg          , Gg          , Rp          , Rp          , Rp          , Rp          , Rp          , Rp          , Rr          , Rr          , Ce          , Rr          , Rp          , Gg          , Gg          , Gg          , Gs^Fp       , Gs^Fp       
Cea         , Aa          , Rb          , Gg          , Re          , Re          , Re          , Rp          , Re          , Gs^Fp       , Rp          , Rp^Es       , Rp          , Rr          , Rr          , Rr          , Rp          , Re          , Re          , Gg          , Gg          , Gg          
Cea         , Aa          , Re^Gvs      , Re          , Re^Gvs      , Re^Gvs      , Re^Gvs      , Gg^Vh       , Gs^Fp       , Re          , Rp          , Rp          , Ce          , Ce          , Gg          , Rp          , Re          , Rp          , Re          , Re          , Re          , Gg          
Cea         , Aa          , Re^Gvs      , Re^Gvs      , Re^Gvs      , Re^Gvs      , Re^Gvs      , Re          , Re          , Re          , Ce          , Ce          , Gg          , Gg          , Gg          , Gg          , Gg          , Re          , Re          , Re          , Re          , Re          
Aa          , Aa          , Re^Gvs      , Re^Gvs      , Re^Gvs      , Re^Gvs      , Re          , Re          , Re          , Re          , 1 Ke        , Ce          , Gg          , Aa          , Aa          , Aa          , Aa          , Gg          , Gg          , Re          , Re          , Re          
Aa          , Re^Gvs      , Re^Gvs      , Re^Gvs      , Re^Gvs      , Re^Gvs      , Re^Gvs      , Re          , Aa          , Cea         , Gg          , Gg          , Gg          , Gg          , Aa^Fpa      , Aa^Fpa      , Aa^Fpa      , Aa          , Aa          , Gg          , Gg          , Re          
Aa          , Ha          , Ha          , Ha          , Aa          , Aa          , Aa          , Aa          , Cea         , Cea         , Aa          , Aa          , Aa          , Aa          , Aa          , Ha          , Ha          , Aa          , Aa          , Gg          , Gg          , Gg          
