Aa, Ha, Ha^Fpa, Ha^Fpa, Ha^Fpa, Ms, Ms, Ms, Ha, Ha^Qhh, Ha^Qhh, Ha^Qhh, Ha^Qhh, Ha^Qhh, Ha^Qhh, Ha^Qhh, Ha^Qhh, Ha^Qhh, Ha^Qhh, Ha^Qhh, Ha^Qhh, Ha, Ha, Ha, Ms, Ms, Ms, Ms, Ms, Ms, Ms, Ms, Ms, Ms, Ms, Ms, Ha
Aa, Ha, Ha, Ha^Fpa, Ha^Fpa, Ha^Fpa, Ha, Ha, Ha, Ha^Qhh, Ha, Ha, Ha, Ha, Aa, Aa, Aa, Aa, Aa, Ha, Ha^Qhhf, Ha, Ha^Fpa, Ha^Fpa, Ha^Fpa, Ha, Ha, Ha, Ha, Ha, Aa, Aa^Fpa, Aa^Fpa, Aa^Fpa, Aa^Fpa, Ha, Ha
Aa, Aa, Aa^Vca, Aa^Fpa, Aa^Fpa, Aa^Fpa, Aa^Fpa, Ai, Ai, Aa^Qhh, Aa^Qhh, Re^Gvs, Re^Gvs, Aa, Gg, Gs^_mh, Re^Gvs, Gs, Gs, Aa, Aa^Qhhf, Aa^Fpa, Aa^Fpa, Aa^Fpa, Aa^Fpa, Aa^Fpa, Gg, Re^Gvs, Re^Gvs, Re^Gvs, Re^Gvs, Gg^Vc, Gg, Aa, Aa, Aa^Fpa, Ha
Aa, Aa, Aa^Fpa, Aa^Fpa, Aa^Fpa, Aa^Fpa, Aa, Ai, Ai, Ai, Aa^Qhh, Re^Gvs, Re^Gvs, Gg^Vc, Re^Gvs, Re^Gvs, Re^Gvs, Re^Gvs, Re, Gll^Fmw, Gg^Qhh, Aa^Fpa, Aa^Fpa, Aa^Fpa, Aa^Fpa, Aa^Fpa, Re, Re, Re, Re^Gvs, Re^Gvs, Re^Gvs, Gg^Esa, Aa^Fpa, Aa, Aa, Ha
Aa, Aa^Fpa, Aa^Fpa, Aa^Fpa, Aa^Fpa, Aa^Fpa, Aa, Aa, Aa, Aa, Aa^Qhhf, Re^Gvs, Aa^Fpa, Re^Gvs, Re^Gvs, Re^Gvs, Re^Gvs, Re^Gvs, Re^Qhh, Re^Qhh, Re, Gg, Gs^Fp, Gs^Fp, Gg, Re, Uue, Uue, Re, Re^Gvs, Re^Gvs, Re^Gvs, Aa, Aa, Ai, Aa^Fpa, Ha
Aa, Aa^Fpa, Aa^Fpa, Aa^Fpa, Aa^Fpa, Aa, Aa, Aa, Aa^Fpa, Aa^Fpa, Aa^Fpa, Aa^Qhhf, Aa^Qhh, Gg^Gvs, Gg^Qhhf, Gg^Qhh, Gg^Qhh, Gg^Qhhf, Uue, Re, Re, Gg, Gg, Aa^Fpa, Aa, Re, Re, Uue, Re, Gg, Aa, Aa, Aa, Aa^Fpa, Aa^Fpa, Aa^Fpa, Ha
Aa, Aa^Fpa, Aa^Fpa, Aa^Fpa, Gg, Gg^Esa, Aa, Aa^Fpa, Aa^Fpa, Aa^Fpa, Aa^Fpa, Aa, Gg, Gg^Qhh, Re^Gvs, Re^Gvs, Re^Gvs, Re^Gvs, Uue, Uue, Re, Gg, Cea, Aa, Cea, Gg, Ce, Re, Ce, Gg, Ce, Gg, Gg^Esa, Aa, Aa, Aa^Fpa, Aa
Aa, Aa, Aa, Gg^Fp, Gg, Gg, Gg, Aa, Aa^Vca, Aa^Fpa, Aa, Aa, Gg, Gg, Gg^Vc, Re^Gvs, Re^Gvs, Re^Gvs, Re, Uue, Re, Aa, Aa, Cea, Aa, Ce, Gg, Ce, Re^Gvs, Ce, Re^Gvs, Ce, Cea, Ha, Ha, Aa, Aa
Aa, Aa, Aa, Gg, Ce, Ce, Gg, Gg, Gg, Gg, Gs, Gs, Aa, Aa, Aa, Re^Gvs, Re^Gvs, Re^Gvs, Gg, Re, Gg, Gg, Gg^Esa, Aa, Aa, Gg, Re^Gvs, Re^Gvs, Re^Gvs, Re^Gvs, Re^Gvs, Re^Gvs, Re^Gvs, Cea, Ha^Fpa, Ha^Fpa, Aa^Fpa
Aa, Aa, Aa, Gg, Ce, 1 Ke, Ce, Gg, Gg, Gg^Es, Gs, Gs, Gs^Fp, Aa, Gd, Gll^Fp, Gg, Gg, Aa, Gg, Ce, Ce, Ce, Gg, Gg^Es, Gll^Fp, Re^Gvs, Re^Gvs, Re^Gvs, Re^Gvs, Re^Gvs, Re^Gvs, Re^Gvs, Cea, Ha^Fpa, Ha^Fpa, Aa
Aa, Aa, Re, Gg, Gg, Gll^Fdw, Gg, Gg, Gs, Gs, Gg, Gg, Gll, Gg, Gg, Gg, Gg, Gg^Es, Gg, Gg, Re, Ke, Re, Gg, Gg, Gg, Gg, Gs^Fp, Re^Gvs, Re^Gvs, Gg, Re^Gvs, Re^Gvs, Cea, Ha, Ha, Ms
Re, Aa^Fpa, Re, Uue, Rd, Rd, Rd, Re, Re, Gg, Re, Gll^Fmw, Gll^Fdw, Gg, Aa, Aa, Gg, Gg, Gs^Fp, Gg, Gg, Re, 2 Gg, Gg, Gs^Vc, Gg, Gg^Wm, Gg^Vh, Re, Gg, Gd, Gg, Re^Gvs, Cea, Ha, Ms, Ms
Re, Re, Re, Rd, Gs, Rd, Re, Re, Re, Re, Re, Re, Re, Gll, Aa, Re, Re, Re, Re, Re, Re, Re, Re, Re, Re, Re, Re, Re, Rp, Rp, Gg^Fet, Re^Efm, Re^Gvs, Cea, Ha, Ms, Ms
Aa, Aa, Aa, Gs, Gs^Es, Gs, Gs, Gs^Fp, Gs^Eff, Gs^Eff, Re^Gvs, Re^Gvs, Re^Gvs, Re, Re^Gvs, Re, Gs, Re, Gd, Re, Gg, Re, 3 Gll, Re, Gs^Vc, Gg^Wm, Re, Gg^Wm, Rp, Rr^Vhc, Gs^Efm, Gd^Efm, Re^Gvs, Cea, Cea, Ha, Aa
Aa, Aa, Aa, Gs, Gg, Gll^Fp, Re, Gll^Fmw, Uue, Gs^Eff, Gs, Re^Gvs, Re^Gvs, Re^Gvs, Re^Gvs, Gll^Fp, Re^Gvs, Uue, Re, Gd, Re, Re, Re, Gs, Gll, Gs, Re, Gg^Vh, Gs, Rp, Re^Gvs, Re^Gvs, Re^Gvs, Cea, Re^Esa, Aa^Fpa, Aa^Fpa
Aa, Aa, Aa^Fpa, Aa, Aa, Gs, Gs, Uue, Re, Gs, Gg, Re^Gvs, Aa, Aa, Re^Gvs, Re^Gvs, Re^Gvs, Re^Gvs, Gll, Gd, Ce, Ke, Ce, Gs, Re, Gs^Fp, Isa, Gg^Es, Re^Gvs, Re^Gvs, Rd^Gvs, Rd^Gvs, Re^Gvs, Uue, Re, Gs^Fp, Aa^Fpa
Aa, Aa^Fpa, Aa^Fpa, Aa^Fpa, Aa^Fpa, Gs^Fp, Gg, Gs, Gll, Gll, Aa^Fpa, Aa, Gs^Eff, Aa^Vca, Re^Gvs, Re^Gvs, Re^Gvs, Re^Gvs, Re^Gvs, Re^Gvs, Gs, Ce, Re^Gvs, Uue, Uue, Gs, Rd^Qhu, Rd, Rd, Re^Gvs, Re^Gvs, Rd^Gvs, Re^Gvs, Re, Re^Esa, Aa^Fpa, Aa^Fpa
Aa, Aa^Fpa, Aa^Fpa, Aa^Fpa, Aa^Fpa, Aa^Vca, Gll^Fp, Gll, Aa, Aa, Aa, Aa, Aa^Eff, Re^Eff, Re^Gvs, Re^Gvs, Re^Gvs, Re^Gvs, Re^Gvs, Re^Gvs, Re^Gvs, Re^Gvs, Re^Gvs, Uue, Re^Qhu, Rd^Qhu, Ww^Bw|, Rrd^Qhu, Ww^Qhu, Gg, Gg, Re^Gvs, Re^Gvs, Cea, Aa^Fpa, Aa^Fpa, Aa^Fpa
Aa, Aa, Aa^Fpa, Aa^Fpa, Aa^Fpa, Aa^Fpa, Aa^Fpa, Aa^Fpa, Aa^Fpa, Aa, Aa^Fpa, Aa, Aa, Re^Eff, Re^Eff, Re^Gvs, Re^Gvs, Re^Gvs, Re^Gvs, Re^Gvs, Re^Esa, Re^Gvs, Re^Gvs, Re^Gvs, Gd^Qhu, Ww, Ww, Ww, Ww, Ww^Qhu, Gs^Fp, Re^Gvs, Cea, Cea, Aa^Fpa, Aa^Fpa, Aa^Fpa
Aa, Aa, Aa^Fpa, Aa^Fpa, Aa^Fpa, Aa^Fpa, Aa^Fpa, Aa^Fpa, Aa^Fpa, Aa^Fpa, Aa^Fpa, Aa^Fpa, Aa^Fpa, Aa, Re^Gvs, Re^Gvs, Re^Gvs, Re^Gvs, Aa^Fpa, Re^Gvs, Re^Gvs, Re^Gvs, Ai^Qhu, Gs^Qhu, Ww, Ww, Ww^_ml, Ww, Ww, Gs^Qhuf, Aa^Qhuf, Gs^Fp, Aa^Fpa, Aa^Fpa, Aa^Fpa, Aa^Fpa, Aa^Fpa
Aa, Aa, Aa^Fpa, Aa^Fpa, Aa^Fpa, Aa^Fpa, Aa, Aa^Fpa, Aa^Fpa, Aa^Fpa, Aa^Fpa, Aa^Fpa, Aa^Fpa, Aa, Aa, Gs^Fp, Aa, Aa^Fpa, Aa^Fpa, Aa^Fpa, Aa^Fpa, Gg^Qhu, Ai, Ai, Ai, Ww, Ai, Ai, Ai, Ai, Aa^Qhuf, Aa^Fpa, Aa^Fpa, Aa^Fpa, Aa^Fpa, Aa^Fpa, Aa
Aa, Aa, Aa, Aa, Aa, Aa, Aa, Aa, Aa, Aa, Aa, Aa, Aa, Aa, Aa, Aa, Aa, Aa, Aa, Aa, Aa, Aa^Qhu, Aa^Qhu, Aa^Qhuf, Aa^Qhuf, Aa^Qhuf, Aa^Qhuf, Ai^Qhu, Aa^Qhuf, Ai^Qhu, Aa^Fpa, Aa^Fpa, Aa^Fpa, Aa^Fpa, Aa^Fpa, Aa^Fpa, Aa^Fpa
