Aa^Qhu, Aa^Qhu, Aa^Qhu, Ha^Qhu, Ha^Qhu, Ha^Qhu, Exos, Exos, Exos^Edb, Exos, Exos, Exos, Uu^Qhu, Qlf, Qlf, Qlf, Uu^Qhu, Uu^Qhu
Aa^Qhu, Aa^Qhu, Aa^Fpa, Aa, Aa, Uu, Uu, Exos^Edb, Exos^Edb, Exos^Edb, Uu^Edb, Uu, Wwg, Uu^_mll, Uu, Qlf, Uu^Qhu, Uu^Qhu
Aa^Qhu, Aa^Qhu, Aa^Qhu, Aa, Aa^Fpa, Uu, Aa, Uu, Uu^Qhu, Uu^Edb, Uu^Qhu, Uu^Ahsy, Wwg, Wwg, Wwg, Uu, Aa^Qhu, Uu^Qhu
Aa^Qhu, Aa, Aa, Aa^Qhuf, Aa^Qhuf, Aa, Aa^Qhu, Aa^Qhu, Uu, Uu^Qhu, Rb, Aa^Qhu, Aa^Qhuf, Aa^Fpa, Aa^Qhuf, Aa^Qhu, Aa, Aa^Qhu
Aa^Qhu, Aa, Aa, Aa, Aa, Aa^Qhu, Aa^Fpa, Aa, Aa, Uu^Edb, Rb^Edb, Rb, Uu, Aa^Qhuf, Aa, Aa, Exos, Exos
Aa^Qhu, Aa^Fpa, Aa^_ml, Aa, Aa^Fpa, Aa, Aa^Fpa, Aa^Fpa, Aa^Fpa, Uu^Edb, Rb, Rb^Dr, Iwo, Uu, Exos^Dr, Exos^Dr, Exos, Exos^Dr
Aa^Qhu, Aa, Aa^Ahsy, Aa^Fpa, Uu, Ur, Aa, Aa^Fetd, Aa^Qhu, Uu^Qhu, Uu^Qhu, Rb^Es, Iwo, Rb, Exos, Exos^Dr, Exos, Exos
Aa^Qhu, Aa, Aa^Qhu, Uu, Uu, Uu, Aa^Qhu, Aa^Qhu, Uu, Uu, Iwo, Iwo^Qhu, Uu^Qhu, Uu, Rb, Exos, Uu, Uu
Aa^Fpa, Aa^Qhu, Aa, Aa^Qhu, Rb^Qhu, Iwo^Qhu, Iwo, Rb, Uu, Uu, Qlf, Iwo, Aa, Aa^Qhu, Aa^Qhu, Rb, Aa^Qhu, Aa^Qhu
Aa^Fpa, Aa^Fpa, Aa, Aa, Rra^Esa, Iwo, Rb^Es, Rb, Iwo, Iwo, Re, Rb^Esa, Re, Aa, Aa, Aa^Qhuf, Aa, Aa
Ha, Aa^Fpa, Ha, Rb, Rra, Rb, Rp, Rb, Rb, Iwo, Rb, Iwo, Iwo, Re, Aa, Aa, Aa, Aa
Ha, Ha, Ha, Aa, Rb, Rra^Vhr, Rb, Rb^Qhu, Rb, Re, Re, Iwo, Re, Re, Aa, Aa, Aa, Aa
Aa^Fpa, Ha, Aa, Aa, Aa, Rb, Re, Rb^Es, Re, Re, Aa, Re, Aa, Aa, Ha, Aa, Aa^Fpa, Aa^Fpa
Aa^Fpa, Aa^Fpa, Aa^Fpa, Aa, Aa, Aa, Re, Re, Aa, Aa, Aa^Fpa, Aa, Aa, Ha, Aa, Aa^Fpa, Aa^Fpa, Aa^Fpa
Aa^Fpa, Aa, Aa^Fpa, Aa, Aa, Aa, Aa, Re, Aa, Aa, Aa^Fpa, Aa^Fpa, Aa, Ai, Ai, Aa, Ha, Aa^Fpa
Aa, Aa, Aa, Aa, 1 Re, Re, Aa, Aa, Aa, Aa, Aa, Aa, Aa, Ai, Aa, Aa, Aa, Aa
Aa, Aa, Re, Re, Re, Re, Re, Aa, Aa, Aa, Aa, Aa, Aa, Aa, Aa, Ha, Ha, Ha
Aa, Aa, Re, Re, Re, Aa, Aa, Aa, Aa, Aa, Aa, Aa, Aa, Aa, Aa, Ha, Ha, Ha
