Ha, Ms, Ms, Ha, Ms, Ms, Ms, Ms, Ms, Ms, Ms, Ms, Ha^Fpa, Ha, Ha^Fpa, Ms, Ms, Ms, Ms, Aa^Fpa, Aa^Qhhf, Aa^Qhhf, Aa^Qhhf, Aa^Qhhf, Ha^Qhh, Ms^Qhh, Ms^Qhh, Ms^Qhh, Ms^Qhh, Ms^Qhh, Ms^Qhh, Ms^Qhh, Ms^Qhh, Ms^Qhh, Ms^Qhh, Ms^Qhh, Ms^Qhh, Ha^Qhh, Ha^Qhh, Aa^Qhh, Wwr, Ww^Qhh, Ww^Qhh, Ww^Qhh, Wwr, Ww^Qhh, Ms^Qhh, Aa^Qhh, Ms^Qhh, Ms^Qhh, Ms^Qhh, Ms^Qhh, Ms^Qhh, Ha^Qhh, Ms, Ms, Ms, Aa, Ms, Ms, Ms, Ms, Ms, Ms, Ms, Ms, Ms
Ha, Ha, Ms, Ms, Ms, Ms, Ms, Ms, Ms, Ms, Ha, Ha, Ha, Ha^Fpa, Ha^Fpa, Ms, Ms, Ms, Ms, Aa^Fpa, Aa^Fpa, Aa^Qhhf, Aa^Qhhf, Ha^Fpa, Ha^Fpa, Ms, Ms, Ms, Ms, Ms, Ms, Ms, Ms, Ms, Ms, Ms, Ms, Ha, Ha, Aa, Ai, Wwr, Ww, Ww, Ai, Ms, Ms, Ms, Ms, Ms, Ms, Ms, Ms, Ha^Qhh, Ms, Ms, Ms, Ms, Ms, Ms, Ms, Ms, Ms, Ms, Ms, Ms, Ms
Ha, Ha, Ha, Ha, Ha, Ms, Ha, Ha, Ha, Ha, Ha, Ha, Ha, Ha^Fpa, Ha^Fpa, Ha^Fpa, Ha^Fpa, Ms, Ha^Fpa, Ha^Fpa, Aa^Fpa, Aa^Qhhf, Aa^Qhhf, Aa^Fpa, Aa^Fpa, Ha^Fpa, Ha, Ms, Ha, Ms, Ms, Ms, Ha, Ha, Ha, Ms, Ha, Ha, Aa, Aa, Ai, Ww, Ww^_mh, Ww, Ai, Ms, Ms, Ms, Ms, Ms, Ms, Ms, Ha, Ha^Qhh, Ha, Ms, Ms, Ms, Ms, Ms, Ms, Ms, Ms, Ms, Ms, Ms, Ms
Aa, Ha, Ha, Ha, Ha, Cea, Ha, Ha, Ha, Ha, Ha, Ha, Ha, Ha, Aa^Fpa, Ha^Fpa, Ha^Fpa, Ha^Fpa, Aa^Fpa, Aa^Fpa, Aa^Fpa, Aa^Fpa, Aa^Qhhf, Aa^Fpa, Aa^Fpa, Aa^_mh, Aa, Ha, Aa, Ha, Ha, Ha, Ha, Ha, Aa, Aa, Aa^Fpa, Aa, Aa, Aa, Wwf, Ww, Wwr, Ww, Ai, Ai, Aa^Fpa, Aa^Fpa, Aa^Fpa, Aa^Fpa, Aa^Fpa, Aa^Fpa, Ha^Qhh, Ha^Qhh, Ha, Ha, Ms, Ms, Ms, Ms, Ms, Ms, Ms, Ms, Ms, Ms, Ms
Aa^Fpa, Aa, Aa, Ha, Aa^Vca, Ha, Rb^Eqp, Rb^Eqp, Rb^Eqp, Ha, Aa^Fpa, Ha, Aa, Aa^Vca, Aa, Aa^Fpa, Aa, Aa^Fpa, Aa^Fpa, Aa^Fpa, Aa^Fpa, Aa^Fpa, Aa^Fpa, Aa^Qhh, Aa^Qhh, Aa, Aa, Aa^Fpa, Aa^Fpa, Aa, Aa, Aa, Aa^Fpa, Aa, Aa^Fpa, Aa^Fpa, Aa^Fpa, Aa^Fpa, Aa^Qhhf, Wwf, Wwf^Qhh, Wwf, Wwg, Ai, Aa^Fpa, Aa^Fpa, Aa^Qhhf, Aa^Qhhf, Aa^Qhhf, Aa^Qhhf, Aa^Qhhf, Aa^Qhhf, Aa^Fpa, Ha, Ha, Ha, Ha, Ms, Ms, Ms, Ms, Ms, Ms, Ms, Ms, Ms, Ms
Aa^Fpa, Aa^Fpa, Aa, Aa, Rb^Eqp, Rb^Eqp, Rb^Edb, Rb^Edb, Rb^Edb, Rb^Eqp, Aa^Eqp, Aa, Aa, Aa, Aa, Aa, Aa^Fpa, Aa^Fpa, Tyb, Aa^Fpa, Re, Gs^Fp, Gs^Fp, Gs^Fp, Gs^Fp, Aa^Qhhf, Aa^Qhh, Aa^Qhh, Aa^Qhh, Aa, Aa^Qhh, Aa^Fpa, Aa^Qhhf, Aa^Qhh, Aa^Qhh, Aa^Fpa, Aa^Qhhf, Aa^Fpa, Aa^Qhhf, Wwf^Qhh, Ww, Wwf^Qhh, Wwf^Qhh, Wwg, Aa^Qhhf, Aa^Qhhf, Aa^Fpa, Aa^Fpa, Aa^Fpa, Aa^Qhhf, Aa^Fpa, Aa^Fpa, Aa^Fpa, Ha, Ha, Ha, Ha, Ha, Ha, Ms, Ha, Ms, Ms, Ms, Ms, Ms, Aa
Aa, Aa^Fpa, Aa, Rb^Eqp, Rb^Eqp, Rb^Edb, Rb^Edb, Rb, Rb^Pr/, Rb^Eqp, Aa^Fpa, Aa, Rb, Rb, Rb, Aa, Aa, Tyb, Tyb, Gs^Fp, Gs^Fp, Re, Uu, Uu, Uu, Gs^Fp, Aa, Aa^Fpa, Aa, Aa^Qhh, Aa^Fpa, Aa^Qhhf, Aa^Fpa, Aa^Fpa, Aa^Fpa, Aa^Qhhf, Aa^Fpa, Aa^Qhh, Aa^Fpa, Ai, Ww, Ww, Ww, Wwf^Qhh, Aa^Fpa, Aa^Fpa, Aa^Fpa, Aa^Fpa, Aa^Fpa, Aa^Fpa, Aa^Fpa, Aa^Fpa, Aa^Fpa, Aa^Fpa, Aa^Fpa, Ha, Ha, Ha, Ha, Ha, Ha, Ha, Ha, Ms, Ha, Ha, Ha
Aa, Aa^Fpa, Aa, Aa, Aa^Fpa, Rb^Eqp, Rb^Eqp, Rra^Eqp, Rb, Rb, Aa^Fpa, Aa^Fpa, Aa, Rb^Es, Aa, Aa, Aa^Fpa, Aa^Fpa, Aa^Fpa, Aa^Fpa, Gs^Fp, Re, Uu, Uh, Uu, Re, Re, Aa, Aa, Aa, Aa^Fpa, Aa^Fpa, Aa^Fpa, Aa^Fpa, Aa^Fpa, Aa^Fpa, Aa^Fpa, Aa^Fpa, Aa^Fpa, Ai, Ww, Wwr, Ww, Ai, Aa, Aa^Fpa, Aa^Fpa, Aa^Fpa, Aa, Aa, Aa^Fpa, Aa^Fpa, Aa^Fpa, Aa^Fpa, Aa^Fpa, Ha^Fpa, Ha^Fpa, Ha, Ha, Ha, Ha, Ha, Ha, Ha, Ha, Ha, Ha
Tyb, Aa, Aa, Aa, Aa^Fpa, Aa^Fpa, Aa^Fpa, Rb, Rb^Ecf, Cea, Rb, Aa, Aa, Aa, Aa^Fpa, Aa^Fpa, Aa, Aa^Fpa, Aa^Fpa, Ai, Aa^Fpa, Gs^Fp, Gs^Fp, Uu, Gs^Fp, Gs^Fp, Re, Re, Rrd, Gs^Fp, Gs^Fp, Aa^Fpa, Aa^Fpa, Aa^Fpa, Aa, Aa, Aa^Fpa, Aa^Fpa, Aa^Fpa, Ai, Ww, Ww, Ww, Ai, Rb, Rb, Rb, Aa^Fpa, Aa^Fpa, Aa, Aa^Fpa, Aa^Fpa, Ha^Fpa, Aa^Fpa, Aa^Fpa, Aa^Fpa, Aa, Ha^Fpa, Ha^Fpa, Ha, Ha^Fpa, Ha, Ha, Ha, Ha, Ha, Ha
Tyb, Tyb, Aa^Fpa, Aa^Fpa, Aa, Aa^Fpa, Rb, Rb, Aa^Fpa, Aa^Fpa, Aa, Aa, Aa^Fpa, Aa, Aa^Fpa, Aa^Fpa, Aa^Fpa, Aa^Fpa, Ss, Ss, Aa^Fpa, Aa^Fpa, Aa^Fpa, Gs^Fp, Gs^Fp, Ss, Ss, Rrd, Ww, Ww, Gs^Fp, Aa^Fpa, Aa^Fpa, Aa^Fpa, Aa^Fpa, Aa^Fpa, Aa^Fpa, Aa^Fpa, Ai, Ai, Ww, Wo, Ww, Aa, Aa, Rb, Aa, Aa^Fpa, Aa^Fpa, Aa^Fpa, Aa^Fpa, Ha^Fpa, Ha^Fpa, Aa^Fpa, Aa^Fpa, Aa^Fpa, Aa, Aa^Fpa, Aa^Fpa, Ha^Fpa, Ha^Fpa, Ha^Fpa, Ha^Fpa, Ha^Fpa, Ha^Fpa, Ha^Fpa, Ha^Fpa
Aa, Aa, Aa^Fpa, Aa^Fpa, Aa, Aa, Rb, Aa^Fpa, Aa^Fpa, Aa^Fpa, Aa, Aa, Aa, Aa, Aa^Fpa, Aa^Fpa, Aa^Fpa, Aa^Fpa, Ai, Ss, Aa^Fpa, Aa^Fpa, Aa^Fpa, Aa^Fpa, Aa, Gs^Fp, Ss, Ds, Ww, Ww, Wo, Gd^Fetd, Gs^Fp, Aa^Fpa, Aa^Fpa, Aa^Fpa, Aa^Fpa, Aa^Fpa, Ai, Ai, Ww, Ww, Ww, Cea, Aa, Aa, Aa^Fpa, Aa, Aa^Fpa, Aa^Fpa, Aa^Fpa, Aa^Fpa, Aa^Fpa, Aa^Fpa, Aa^Fpa, Aa, Aa, Aa^Fpa, Aa, Aa, Aa, Aa, Aa, Ha^Fpa, Aa^Fpa, Ha^Fpa, Aa^Fpa
Aa, Aa, Aa^Fpa, Aa^Fpa, Aa^Fpa, Aa^Fpa, Rb, Aa^Fpa, Aa, Aa, Aa, Aa^Fpa, Aa, Aa, Tyb, Aa^Fpa, Aa^Fpa, Ai, Wwg, Ai, Tyb, Aa^Fpa, Aa^Fpa, Aa^Vca, Aa, Gs^Fp, Re, Ds, Ds, Ww, Ss, Ss, Ds, Aa^Vca, Aa, Aa^Fpa, Aa, Aa, Ai, Ai, Ww, Ai, Wwrg, Aa, Aa, Aa^Esa, Aa, Aa, Aa, Rb, Re, Re, Re, Aa^Fpa, Aa, Aa, Aa, Aa, Aa, Aa, Aa, Aa, Aa, Aa, Aa^Fpa, Aa^Fpa, Aa^Fpa
Aa, Aa^Fpa, Aa^Fpa, Aa^Fpa, Aa^Fpa, Aa^Fpa, Aa, Rb, Rb, Aa, Aa, Aa, Aa, Aa^Fpa, Tyb, Tyb, Wwf, Wwf, Wwg, Ai, Aa, Tyb, Aa^Fpa, Aa, Gs^Fp, Gs^Fp, Hh^Fp, Gs^Fp, Gs^Fp, Ds, Rrd, Ss, Ds, Aa, Re, Aa, Ai, Ai, Ww, Ww, Ww, Wo, Ai, Aa, Ss, Aa, Aa^Fpa, Aa, Aa, Aa, Aa, Re, Rb, Rb, Rb, Aa, Rb, Cea, 1 Ke, Cea, Aa, Aa, Aa, Aa, Aa^Fpa, Aa^Fpa, Aa^Fpa
Aa, Aa^Fpa, Aa^Fpa, Aa^Fpa, Aa^Fpa, Aa^Fpa, Aa, Aa, Rb, Aa^Fpa, Aa^Fpa, Rb, Aa, Aa, Aa, Ai, Wwg, Wwg, Ai, Ai, Aa^Fpa, Aa^Fpa, Aa^Fpa, Aa, Hh^Fp, Hh^Fp, Uue, Gs^Fp, Gd^Fetd, Rrd, Ai, Ds, Rb, Rb, Ai, Ai, Ai, Ww, Ww, Wo, Wo, Ai, Ss, Ss, Ss, Gs^Fp, Gs^Fp, Gs^Fp, Gs^Fp, Aa, Gs^Fp, Rb, Ha^Fpa, Ha^Fpa, Aa, Rb, Rb, Ce, Re, Ce, Cea, Aa, Aa, Aa, Aa, Aa^Fpa, Aa^Fpa
Aa, Aa^Fpa, Aa^Fpa, Aa^Fpa, Aa^Fpa, Aa^Fpa, Aa, Aa, Aa^Fpa, Rb, Chr, Chr, Rb, Aa, Aa^Esa, Ai, Ss, Ss, Ss, Aa, Aa, Aa^Fpa, Aa, Gs^Fp, Chr, Uue, Uh, Uue, Rb, Gg^Vc, Ai, Ai, Aa^Esa, Rb, Rb, Ai, Ai, Ai, Ww, Wo, Ww, Ai, Ai, Ss, Chs, Sm, Rb, Gd^Fetd, Uu, Rb, Rb, Aa, Ha^Fpa, Ha^Fpa, Cea, Aa, Aa, Rb, Re, Ce, Aa, Aa, Aa, Aa^Fpa, Aa, Aa^Fpa, Aa^Fpa
Aa, Aa, Aa, Aa^Fpa, Aa, Aa, Aa, Aa^Fpa, Aa^Fpa, Aa^Fpa, 2 Ke, Rr^Es, Aa, Aa, Aa, Aa, Ss, Ss, Aa^Fpa, Aa^Fpa, Aa^Fpa, Aa^Fpa, Cea, 3 Kea, Ce, Uu, Uu, Uu, Rb, Gg, Ai, Ai, Aa, Rb, Rb, Rb, Rb, Ai, Ww, Ai, Wwrg, Ai, Ai, Ds^Es, Ds^Es, Gs^Fp, Rb, Uu, Qlf, Uh, Rb, Aa, Ha^Fpa, Ha^Fpa, Aa, Aa, Aa, Rb, Rb, Rb, Aa, Aa, Aa, Aa, Aa, Aa^Fpa, Aa^Fpa
Aa, Aa, Aa, Aa, Re, Aa, Re, Aa^Es, Rb, Ce, Ce, Ce, Ce, Aa, Aa, Aa, Aa, Aa^Fpa, Aa^Fpa, Aa^Fpa, Aa, Aa, Rb, Cea, Gg, Rb, Rb, Rb, Ai, Ai, Cha, Aa^Es, Rb, Rb, Rb, Rb^Es, Rb, Rb, Ai^Bw\, Ww, Ww, Ai, Ww, Ww, Aa, Aa, Rb, Uh, Uu, Uh, Aa, Aa, Aa^Fpa, Ha^Fpa, Aa, Aa, Aa, Rb^Vct, Rb, Rb, Rb^Vct, Aa, Aa, Aa, Aa, Aa^Fpa, Aa^Fpa
Rb, Rb, Rb, Aa, Re, Re, Aa, Re, Rb^Es, Rr, Rr^Es, Rr, Re, Re, Rb, Rb, Rb, Rb, Wwf, Ss, Wwf, Re, Re, Re, Rb, Rb, Rb, Re^Es, Re, Ai, Rr, Rr, Re, Re, Ai, Ai, Ai, Ai, Ww, Ww^Bw\r, Ww^Bw\r, Ww, Ai, Ww, Cea, Aa, Ds, Rb, Ds, Rb, Aa, Aa, Aa^Fpa, Ha^Fpa, Aa, Aa, Aa, Rb, Re, Re, Rb, Aa, Aa, Aa, Aa, Aa^Fpa, Aa^Fpa
Aa, Re, Re, Re, Re, Aa, Rb, Rb, Aa^Vca, Rb, Re, Re^Ecf, Re, Rb, Aa, Re, Cea, Re, Ss, Wwf, Aa^Fpa, Rr^Esa, Aa^Fpa, Rb, Aa^Vca, Rb, Gs^Fp, Tyb, Ss, Re, Re, Re, Ai, Ai, Ww, Ww, Ww, Ww, Ww, Ww, Wo, Ai^Bw\, Ww^Bw\, Ww, Re, Re, Ai, Ai, Ss, Ss, Rb, Aa, Rb, Rb, Rb, Rb, Rb, Rb, Rb^Ecf, Rb, Rb, Re, Rb, Re, Re, Aa^Fpa, Re
Aa, Aa, Aa, Aa, Aa, Aa, Aa^Fpa, Aa^Fpa, Aa^Fpa, Rb, Ce, Re, Aa, Aa, Ai, Aa, Aa, Aa, Aa, Aa^Es, Aa, Cea, Aa^Fpa, Aa^Fpa, Aa^Fpa, Aa^Fpa, Aa^Fpa, Aa^Fpa, Aa^Fpa, Rb, Rb, Re, Ai, Ww, Wo, Wo, Wo, Ai, Ww, Chw, Wo, Ww, Wo, Rb, Rb, Rb, Rb, Ai, Ss, Rb, Rrd, Rb, Re, Rb, Aa, Re, Aa, Re, Re, Re, Re, Rb, Rb, Rb, Rb, Rb, Rb
Aa, Aa, Aa^Fpa, Aa, Aa, Aa, Aa^Fpa, Aa^Fpa, Rb, Rb, Rb, Rb, Aa, Aa^Fpa, Ai, Ai, Aa, Aa^Vca, Aa, Aa, Ha^Fpa, Tyb, Aa^Fpa, Aa^Fpa, Aa, Aa^Fpa, Aa^Fpa, Aa^Fpa, Aa^Fpa, Aa, Rb, Re^Es, Re, Ai, Ai^Esa, Ai, Ai, Ai, Ww, Wo, Ai, Wwrg, Wwrg, Aa^Fpa, Gs^Fp, Gs^Vc, Ds, Ss, Ss, Ss, Rrd, Ds, Ha^Fpa, Ha^Fpa, Aa, Aa, Aa, Rb, Rb, Rb, Aa, Aa, Aa, Aa, Aa^Fpa, Re, Re
Aa^Fpa, Aa^Fpa, Aa^Fpa, Aa^Fpa, Aa^Fpa, Tyb, Tyb, Aa^Fpa, Aa^Fpa, Rb, Rb^Es, Rb, Aa, Aa^Fpa, Aa, Aa^Esa, Aa, Aa, Aa, Ha^Fpa, Ha^Fpa, Ha^Fpa, Ha^Fpa, Aa^Fpa, Aa^Fpa, Aa^Fpa, Aa^Fpa, Aa^Fpa, Aa^Fpa, Aa, Aa, Rb, Rd, Rrd, Rrd, Ss, Ai, Ai, Ww, Ww, Ww, Ai, Ai, Chr, Aa^Fpa, Gs^Fp, Ds, Gs^Fp, Rrd, Rrd, Aa, Aa^Fpa, Aa^Fpa, Ha^Fpa, Cea, Aa, Aa, Rb, Rb, Rb, Aa, Aa, Aa, Aa, Aa^Fpa, Aa^Fpa, Aa^Fpa
Aa^Fpa, Aa^Fpa, Aa, Aa^Fpa, Aa^Fpa, Tyb, Tyb, Tyb, Aa, Re, Rb, Rb, Aa, Aa, Aa, Aa, Aa^Fpa, Aa^Fpa, Aa^Fpa, Ha^Fpa, Ha^Fpa, Ha^Fpa, Ha^Fpa, Aa^Fpa, Aa^Fpa, Aa^Fpa, Aa^Fpa, Aa^Fpa, Ha, Ha, Ha, Aa, Aa, Aa, Aa^Fpa, Ss, Rrd, Ai^Bw\, Ww^Bw\r, Ww, Rrd, Ww, Ai, Aa^Es, Aa, Aa^Fpa, Ds, Ds, Ds, Ai, Aa^Fpa, Aa^Fpa, Aa, Aa^Fpa, Aa, Aa, Aa, Rb^Vct, Re, Re, Rb^Vct, Aa, Aa, Aa^Fpa, Aa^Fpa, Aa^Fpa, Aa^Fpa
Aa^Fpa, Aa, Aa^Fpa, Aa^Fpa, Aa, Aa, Aa, Aa^Fpa, Aa, Aa, Aa, Rb, Aa, Aa, Aa^Fpa, Aa^Fpa, Aa^Fpa, Aa^Fpa, Aa^Fpa, Aa^Fpa, Aa^Fpa, Ha^Fpa, Aa^Fpa, Aa^Fpa, Aa^Fpa, Aa^Fpa, Tyb, Aa, Aa, Ha, Ha, Ha, Ai, Ai, Ss, Aa^Fpa, Aa, Rrd, Ww, Ww^Bw\r, Rrd^Bw\r, Rrd, Ds, Ds, Aa, Rrd, Aa^Fpa, Aa^Fpa, Aa, Ds, Gs^Fp, Aa^Fpa, Gs^Vc, Aa^Fpa, Aa, Aa^Fpa, Aa, Aa, Re, Rb, Rb, Aa, Aa, Aa^Fpa, Aa^Fpa, Aa^Fpa, Aa
Aa^Fpa, Aa^Fpa, Aa^Fpa, Aa^Fpa, Aa^Fpa, Aa^Fpa, Aa^Fpa, Aa, Aa, Aa^Esa, Aa, Aa, Aa^Vca, Aa, Aa^Fpa, Aa^Fpa, Aa^Fpa, Aa^Fpa, Aa^Fpa, Aa^Fpa, Aa^Fpa, Aa^Fpa, Aa^Fpa, Aa^Fpa, Aa^Fpa, Aa^Fpa, Gs^Fp, Gs^Fp, Gs^Fp, Aa, Aa, Ha, Ai, Wo, Ai, Aa^Fpa, Aa, Aa, Ai, Ww, Ww, Ds^Bw\, Ds^Bw\, Ce, Gs^Fp, Aa, Gs^Fp, Aa^Fpa, Gs^Fp, Gs^Fp, Uu, Gs^Fp, Rb, Gs^Fp, Gs^Fp, Aa, Aa, Rb^Vct, Rb, Rb^Ecf, Rb^Vct, Aa, Aa, Aa^Fpa, Aa^Fpa, Aa^Fpa, Aa
Aa^Fpa, Aa^Fpa, Aa^Fpa, Aa^Fpa, Aa^Fpa, Aa^Fpa, Aa^Fpa, Aa, Aa^Fpa, Aa, Aa, Aa, Aa, Aa, Aa^Fpa, Aa^Fpa, Aa^Fpa, Aa^Fpa, Aa^Fpa, Aa, Aa^Fpa, Aa^Fpa, Tyb, Aa^Fpa, Aa^Fpa, Gs^Fp, Uu, Re, Uu, Re, Aa, Ha, Aa^Vca, Ai, Ai, Ss, Aa^Esa, Rrd, Ai, Ww, Ww, Ww, Ds, Ds, Ds, Gs^Fp, Ds, Gg, Re, Uu, Ql, Uu, Uh, Rb, Hh, Ha, Aa, Aa, Aa, Rb, Aa, Aa, Aa^Fpa, Aa^Fpa, Aa^Fpa, Aa^Fpa, Aa
Aa, Aa^Fpa, Aa^Fpa, Aa^Fpa, Aa^Fpa, Aa, Aa^Fpa, Aa^Fpa, Aa^Fpa, Aa^Fpa, Aa^Fpa, Aa, Aa, Aa, Aa^Fpa, Aa^Fpa, Aa^Fpa, Aa^Fpa, Aa^Fpa, Aa^Fpa, Aa^Fpa, Tyb, Tyb, Tyb, Aa^Fpa, Gs^Fp, Re, Uh, Uu^Qhu, Re, Re, Aa, Aa, Aa, Aa, Aa, Aa, Aa, Ai, Ww, Ww, Ww, Ds, Ds, Gs^Fp, Ds, Ds, Hh, Ds, Uh, Uu, Uh, Rb, Rb, Hh, Ha, Aa, Aa, Aa, Aa, Aa^Fpa, Aa^Fpa, Aa^Fpa, Aa^Fpa, Aa, Aa^Fpa, Aa
Aa, Aa, Aa, Aa^Fpa, Aa^Fpa, Aa^Fpa, Aa^Fpa, Aa^Fpa, Aa^Fpa, Aa^Fpa, Aa^Fpa, Aa, Ha^Fpa, Ha^Fpa, Ha^Fpa, Aa^Fpa, Ha^Fpa, Ha^Fpa, Ha^Fpa, Aa^Fpa, Aa^Fpa, Aa^Fpa, Aa^Fpa, Aa^Fpa, Aa, Gs^Fp, Gs^Qhu, Uu^Qhu, Re, Re^Qhu, Re^Qhu, Re^Qhuf, Aa^Qhu, Aa, Aa^Qhuf, Aa, Aa, Ai, Ww, Ww, Ai, Ww, Gs^Fp, Aa^Fpa, Aa^Fpa, Gs^Fp, Gs^Fp, Ds, Gg, Rb, Rb, Rb, Ds, Gg, Cea, Aa, Aa, Aa, Tyb, Aa, Aa^Fpa, Ha^Fpa, Aa^Fpa, Aa^Fpa, Aa, Aa, Aa
Aa^Fpa, Aa, Aa^Fpa, Aa^Fpa, Aa^Fpa, Aa^Fpa, Aa^Fpa, Aa^Fpa, Aa^Fpa, Aa^Fpa, Ha^Fpa, Ha^Fpa, Ms, Ms, Ms, Ms, Ms, Ha^Fpa, Ha^Fpa, Ha^Fpa, Ha^Fpa, Aa^Fpa, Aa^Fpa, Aa^Qhuf, Aa^Qhuf, Aa^Qhu, Aa, Gs^Fp, Aa^_ml, Aa, Aa^Fpa, Aa, Aa, Aa^Qhuf, Aa^Fpa, Aa^Qhuf, Aa^Qhu, Wwf^Qhu, Ww^Qhu, Wo^Qhu, Ww^Qhu, Ww, Aa^Fpa, Aa^Fpa, Gs^Fp, Gd^Fetd, Gs^Fp, Gs^Fp, Gs^Fp, Gs^Fp, Gg, Rb, Gs^Fp, Gs^Fp, Aa^Fpa, Aa, Aa, Tyb, Tyb, Tyb, Aa^Fpa, Aa^Fpa, Aa^Fpa, Aa^Fpa, Ha, Aa, Aa
Aa^Fpa, Aa^Fpa, Aa^Fpa, Aa^Fpa, Aa^Fpa, Aa^Fpa, Aa^Fpa, Aa^Fpa, Aa^Fpa, Aa^Fpa, Aa^Fpa, Ha^Fpa, Ms, Ms, Ms, Ms, Ms, Ms, Ms, Ha^Fpa, Ms, Ha^Fpa, Ha^Fpa, Aa^Qhuf, Aa^Qhuf, Aa^Qhu, Aa^Fpa, Aa^Fpa, Aa^Fpa, Aa^Fpa, Aa^Fpa, Aa^Fpa, Aa^Fpa, Aa^Fpa, Aa^Fpa, Aa^Fpa, Ww, Wwf, Ww, Wo, Ww, Ww^Qhu, Aa^Qhuf, Aa^Fpa, Aa^Fpa, Aa^Fpa, Aa^Fpa, Aa, Aa^Fpa, Gg, Gs^Fp, Gs^Fp, Aa^Fpa, Aa^Fpa, Ha^Fpa, Aa^Fpa, Aa^Fpa, Aa^Fpa, Aa^Fpa, Tyb, Aa, Aa^Fpa, Ha^Fpa, Ha^Fpa, Ha, Ha, Aa
Aa^Fpa, Aa^Fpa, Aa^Fpa, Aa^Fpa, Aa^Fpa, Aa^Fpa, Aa^Fpa, Aa^Fpa, Aa^Fpa, Aa^Fpa, Aa^Fpa, Ha^Fpa, Ms, Ms, Ms, Ms, Ms, Ms, Ms, Ms, Ms, Ms, Ms, Ha^Fpa, Aa^Fpa, Aa^Qhuf, Aa^Qhuf, Aa^Fpa, Aa^Fpa, Aa^Fpa, Aa^Fpa, Aa^Fpa, Aa^Fpa, Aa^Fpa, Aa^Fpa, Ww, Ww, Ww, Wo, Wo, Wwf, Ai, Ai, Aa^Qhuf, Aa^Qhuf, Aa^Fpa, Aa^Fpa, Aa^Fpa, Aa^Fpa, Aa^Fpa, Aa, Aa, Ha^Fpa, Ha^Fpa, Ha^Fpa, Aa^Fpa, Ha^Fpa, Aa^Fpa, Aa^Fpa, Aa^Fpa, Aa, Aa, Ha, Ha, Ms, Ms, Aa
Aa^Fpa, Aa^Fpa, Aa^Fpa, Aa^Fpa, Aa^Fpa, Aa^Fpa, Aa^Fpa, Aa^Fpa, Aa^Fpa, Aa^Fpa, Aa^Fpa, Ha^Fpa, Aa^Fpa, Ms, Ms, Ms, Ms, Ms, Ms, Ms, Ms, Ms, Ms, Ha^Fpa, Aa^Fpa, Aa^Fpa, Aa^Qhuf, Aa^Qhuf, Aa^Qhuf, Aa^Qhuf, Aa^Qhuf, Aa^Qhuf, Aa^Qhuf, Aa^Qhuf, Aa^Qhuf, Aa^Qhuf, Aa^Qhuf, Wo^Qhu, Ww^Qhu, Wwf^Qhu, Ww, Ai, Ai, Aa^Qhuf, Aa^Fpa, Aa^Qhuf, Aa^Qhuf, Aa^Fpa, Aa^Fpa, Aa^Fpa, Aa, Aa, Ha^Fpa, Ha^Fpa, Ha^Fpa, Ha^Fpa, Aa^Fpa, Aa^Fpa, Aa^Fpa, Aa^Fpa, Aa, Aa, Ha, Ms, Ms, Ms, Aa
