Ai, Ai, Ai, Ai, Ai, Ai, Ai, Ai, Ai, Ai, Aa, Aa, Aa, Aa, Aa, Ha, Ha, Ha, Ha, Ha, Ha, Ha, Ha, Ha, Ha, Ha, Ha, Ha, Ha, Ha, Ha, Ha, Ha, Ha, Ha, Ha, Ha, Ha, Ha, Ha, Ha, Ha
Ai, Ai, Ai, Ai, Cha, Ai, Cha, Ai, Cha, Ai, Ai, Ai, Ai, Ai, Ai, Ai, Ai, Ai, Ai, Ai, Ai, Aa, Ai, Ai, Ai, Ai, Cha, Wo, Cha, Ai, Ai, Ai, Ai, Aa, Aa, Aa, Aa, Aa, Aa, Ha, Aa, Ha
Ai, Ai, Aa, Ai, Cha, Cha, Cha, Cha, Ai, Cha, Cha, Cha, Cha, Cha, Cha, Cha, Cha, Cha, Cha, Cha, Cha, Cha, Cha, Cha, Cha, Cha, Cha, Cha, Cha, Cha, Cha, Cha, Cha, Cha, Cha, Wo, Cha, Ai, Ai, Ai, Aa, Aa
Aa, Aa, Aa, Ai, Cha, Aa, Aa, Ai, Ai, Aa, Rp, Rp, Rp, Rp, Rp, Aa, Rp, Cha, Aa, Rp, Aa, Cha, Rp, Cha, Aa, Aa, Aa, Ai, Aa, Aa, Aa, Aa, Aa, Aa, Aa, Cha, Rp, Cha, Cha, Ai, Aa, Aa
Aa, Aa, Aa, Ai, Cha, Aa, Aa, Aa, Aa, Aa, Aa, Rp, Cha, Cha, Cha, Aa, Aa, Aa, Rp, Aa, Rp, Aa, Rp, Aa, Aa, Aa, Rp, Aa, Aa, Aa, Aa, Aa, Aa, Aa, Aa, Aa, Ch, Rp, Cha, Ai, Aa, Aa
Aa, Aa, Aa, Ai, Cha, Aa, Aa^Vha, Aa^Vha, Aa^Vha, Aa, Aa, Rp, Rp, Cha, Cha, Aa, Rp, Rp, Cha, Cha, Cha, Rp, Rp, Aa, Rp, Ch, Rp, Aa, Aa, Aa, Rrc^Vhca, Aa, Aa, Aa, Aa, Aa, Aa, Aa, Cha, Ai, Aa, Aa
Aa, Aa^Fpa, Ai, Ai, Cha, Aa, Aa, Aa, Aa, Aa, Aa, Aa, Aa, Rp, Aa, Aa, Cha, Cha, Rrc, 1 Kha, Rrc, Cha, Cha, Rp, Rp, Rp, Aa, Aa, Gg^Fet, Gg^Fet, Rr^Vhc, Rr, Rr, Aa, Aa, Aa, Aa, Aa, Cha, Ai, Aa, Aa
Aa, Aa^Fpa, Ai, Ai, Cha, Aa, Aa, Aa, Rr, Rrc^Vhca, Rrc^Vhca, Ai, Ai, Aa, Aa, Rp, Rp, Cha, Aa, Rrc, Rrc, Cha, Rp, Rp, Aa, Aa, Aa, Aa, Rr^Vhc, Rr^Vhc, Rr, Rr, Aa, Rrc^Vhca, Aa, Aa, Aa, Aa, Cha, Ai, Aa, Aa
Aa, Aa^Fpa, Ai, Ai, Cha, Aa, Aa, Aa, Aa, Rr, Rr, Rrc^Vhca, Rrc^Vhca, Ai, Aa, Ai, Rp, Cha, Ai, Aa, Aa, Cha, Rp, Rp, Aa, Ai, Rr, Rr, Rr, Rr, Gg, Rrc^Vhca, Aa, Aa, Aa, Aa, Aa, Aa, Cha, Ai, Aa, Aa
Aa, Aa^Fpa, Aa^Fpa, Wwf, Ai, Cha, Aa, Kha, Cha, Aa, Aa, Rr, Rr, Gg^Fet, Aa, Aa, Rp, Cha, Ai, Ai, Ai, Cha, Aa, Aa, Aa, Rr, Rr, Rr, Aa, Gg, Gg, Rp, Aa, Cha, Kha, Aa, Aa, Aa, Cha, Ai, Aa, Aa
Aa, Aa^Fpa, Aa^Fpa, Ai, Ai, Cha, Cha, Aa, Aa, Aa, Rp, Rp, Rp, Rr, Aa, Aa, Aa, Cha, Aa, Ai, Aa, Cha, Aa, Aa, Rr, Rr, Aa, Aa, Ai, Aa, Aa, Aa, Aa, Cha, Aa, Aa, Aa, Aa, Cha, Ai, Aa, Aa
Aa, Aa^Fpa, Aa^Fpa, Ai, Ai, Ai, Ai, Cha, Cha, Aa, Cha, Rp, Aa, Aa, Aa, Aa, Aa, Cha, Rrc, Cha, Rrc, Cha, Rr, Rr, Rp, Rp, Aa, Aa, Ai, Aa, Aa, Aa, Aa, Aa, Aa, Aa, Cha, Cha, Ai, Ai, Aa, Aa
Aa, Aa^Fpa, Aa^Fpa, Ai, Ai, Ai, Ai, Ai, Ai, Cha, Ai, Cha, Cha, Aa, Cha, Cha, Cha, Rr, Rr, Rr, Rr, Rr, Cha, Cha, Cha, Rp, Cha, Ai, Cha, Ai, Cha, Aa, Cha, Aa, Cha, Cha, Cha, Ai, Ai, Ai, Aa, Aa
Aa, Aa, Aa, Ai, Aa, Ai, Aa, Ai, Ai, Ai, Aa, Ai, Ai, Cha, Ai, Cha, Ai, Cha, Wo^Bw|, Wo^Bw|, Wo^Bw|, Cha, Ai, Cha, Ai, Cha, Ai, Cha, Ai, Cha, Ww, Cha, Ai, Cha, Ai, Ai, Ai, Ai, Ai, Ai, Aa, Aa
Aa, Aa^Fpa, Aa, Aa, Aa, Aa, Aa, Ai, Aa, Ai, Aa, Aa, Aa, Ai, Aa, Ai, Ai, Ai, Wo^Bw|, Wo^Bw|, Wo^Bw|, Ai, Ai, Ai, Ai, Ai, Ai, Ai, Ai, Wo, Ds, Wo, Ai, Ai, Ai, Ai, Aa, Ai, Ai, Ww, Aa, Aa
Ha, Ha, Ha, Aa, Aa, Aa, Aa, Aa, Aa, Aa, Aa, Aa, Aa, Aa, Aa, Aa, Rb, Rb, Wo^Bw|, Wo^Bw|, Wo^Bw|, Rb, Rb, Aa, Aa, Aa, Aa, Aa, Aa, Aa, Ds, Ai, Ai, Ai, Ai, Aa, Aa, Aa, Ai, Ai, Aa, Aa
Ha, Ms, Ms, Ha, Ha, Aa, Aa, Aa, Aa, Aa, Aa, Aa, Aa^Fpa, Aa, Aa, Aa, Rb, Rb, Rb, Rb, Rb, Rb, Rb, Aa, Aa, Aa, Aa, Aa, Aa, Ds, Aa, Aa, Aa, Aa, Aa, Aa, Aa^Vha, Aa^Fpa, Ai, Ai, Aa^Fpa, Aa
Ha, Ms, Ms, Ms, Ms, Ha, Aa^Fpa, Aa^Fpa, Aa^Vha, Aa, Aa, Aa^Fpa, Aa^Fpa, Aa^Fpa, Aa^Fpa, Aa, Aa, Rb, Rb, Rb^Es, Rb, Rb, Rb, Aa, Aa, Aa, Aa, Re, Rb^Gvs, Aa, Aa^Fpa, Aa, Aa^Fpa, Aa, Aa^Fpa, Aa^Fpa, Aa, Aa^Fpa, Ww, Ai, Aa^Fpa, Aa
Ms^Xm, Ms, Ms, Ms, Ms, Ha, Aa^Fpa, Aa^Fpa, Aa, Aa, Aa^Fpa, Aa^Fpa, Aa^Fpa, Aa^Fpa, Aa^Fpa, Aa^Vha, Aa^Fpa, Rb, Rb, Rb, Rb^Es, Rb, Aa, Aa^Fyak, Aa^Fpa, Aa^Fpa, Aa^Fpa, Aa^Vha, Re, Rb^Gvs, Rb^Gvs, Aa^Fpa, Aa^Fpa, Aa^Fpa, Aa^Fpa, Aa^Fpa, Aa^Fpa, Aa^Fpa, Ai, Ai, Ai, Aa
Ms^Xm, Ms^Xm, Ms^Xm, Ms, Ms, Ha, Aa^Fpa, Aa^Fpa, Aa, Aa, Aa^Fpa, Aa^Fpa, Aa^Fpa, Aa^Fpa, Aa^Fpa, Aa^Fpa, Aa^Fpa, Aa, Rb, Rb, Rb, Rb, Aa, Aa, Aa^Fpa, Aa^Eff, Aa^Eff, Aa^Fpa, Aa^Fpa, Rb^Gvs, Rb^Gvs, Rb^Gvs, Aa^Fpa, Aa^Fpa, Aa^Eff, Aa^Fpa, Aa^Fpa, Aa^Fpa, Ai, Ww, Ai, Ai
Ms^Xm, Ms^Xm, Ms^Xm, Ms, Ha, Ha, Aa, Aa, Aa, Aa^Fpa, Aa^Fpa, Aa^Fpa, Aa^Fpa, Aa^Fpa, Aa^Fpa, Aa^Fpa, Aa^Fpa, Aa, Aa, Rb, Rb, Rb, Aa, Aa, Aa^Fpa, Aa^Fpa, Aa^Fpa, Aa^Eff, Aa^Eff, Rb^Gvs, Rb^Gvs, Rb^Gvs, Aa^Vha, Aa^Fpa, Aa^Eff, Aa^Eff, Aa^Fpa, Aa^Fpa, Ai, Ai, Ai, Ai
Ms^Xm, Ms^Xm, Ms^Xm, Ms, Ha, Ha, Aa, Aa, Aa, Aa^Fpa, Aa^Fpa, Aa^Fpa, Aa^Fpa, Aa^Fpa, Aa^Fpa, Aa^Fpa, Aa^Fpa, Aa^Fpa, Aa, Rb, Cea, Rb, Aa, Aa, Aa^Fpa, Aa^Fpa, Aa^Fpa, Aa^Fpa, Aa^Fpa, Aa^Eff, Aa^Eff, Aa^Fpa, Aa^Eff, Aa, Ss^Bw\, Aa^Fpa, Aa^Fpa, Aa^Fpa, Ai, Ai, Ai, Ai
Ms^Xm, Ms^Xm, Ms^Xm, Ms, Ha, Ha, Ha, Aa, Aa, Aa^Fpa, Aa^Fpa, Aa^Fpa, Aa^Fpa, Aa^Fpa, Aa^Fpa, Aa^Fpa, Aa^Fpa, Aa, Aa, Cea, Rb^Ecf, Cea, Aa, Aa, Aa^Fpa, Aa^Fpa, Aa^Fpa, Aa^Fpa, Aa^Fpa, Aa^Fpa, Aa^Fpa, Aa^Eff, Aa^Fpa, Aa^Fpa, Ai, Ai, Ai, Ai, Ai, Ai, Ai, Ai
Ms^Xm, Ms^Xm, Ms^Xm, Ms, Ha, Ha, Ha^Vhha, Ha, Aa^Fpa, Aa^Fpa, Aa^Fpa, Aa^Fpa, Aa^Fpa, Aa^Fpa, Aa^Fpa, Aa^Fpa, Aa^Fpa, Aa, Cea, 2 Kea, Cea, Cea, Aa, Aa, Aa^Fpa, Aa^Fpa, Aa^Fpa, Aa^Fpa, Aa^Fpa, Aa^Fpa, Aa^Fpa, Aa^Fpa, Ai, Ai, Ai, Ai, Ai, Ai, Ai, Ai, Aa^Fpa, Ai
Ha, Ms^Xm, Ms^Xm, Ha, Ha, Ha, Aa^Fpa, Ha, Ha, Aa^Fpa, Aa^Fpa, Aa^Fpa, Aa^Fpa, Aa^Fpa, Aa, Aa^Vha, Rb^Gvs, Rb, Aa, Aa, Rb, Rb, Aa, Aa, Aa^Fpa, Aa^Fpa, Aa^Fpa, Aa^Fpa, Aa^Fpa, Aa, Ai, Ai, Ai, Ai, Ai, Ai, Ai, Ai, Aa^Fpa, Aa^Fpa, Aa^Fpa, Aa
Ha, Ha, Ha, Ha, Ha, Ha, Aa, Aa^Fpa, Aa^Fpa, Aa^Fpa, Aa^Fpa, Aa^Fpa, Aa^Fpa, Aa^Fpa, Aa, Rb^Gvs, Rb^Gvs, Rb^Gvs, Aa, Rb, Rb, Rb, Aa, Aa, Aa^Fpa, Aa^Fpa, Aa^Fpa, Aa^Fpa, Aa^Fpa, Ai, Aa, Ai, Ai, Ss^Vhs, Ai, Ai, Aa^Fpa, Aa^Fpa, Aa^Fpa, Aa^Fpa, Aa^Fpa, Aa
Ha, Ha, Aa^Fpa, Ha, Aa^Fpa, Aa^Fpa, Aa, Aa, Aa^Fpa, Aa^Fpa, Aa, Aa^Fpa, Rb, Aa^Fpa, Aa^Fpa, Aa, Aa^Fpa, Rb, Aa, Rb, Rb, Rb, Aa, Aa^Fpa, Aa^Fpa, Aa^Fpa, Aa^Fpa, Aa^Fpa, Aa^Fpa, Aa, Aa^Fpa, Aa^Fpa, Aa^Fpa, Ai, Aa^Fpa, Ai, Aa^Fpa, Aa^Fpa, Aa^Fpa, Aa^Fpa, Aa^Fpa, Aa
Aa, Ha, Aa^Fpa, Aa^Fpa, Aa^Fpa, Aa^Fpa, Aa^Fpa, Aa^Fpa, Aa, Aa^Fpa, Ha, Aa, Aa^Fpa, Aa^Fpa, Aa^Fpa, Aa^Fpa, Aa^Fpa, Aa, Aa, Rb, Rb, Rb, Aa, Aa, Aa^Fpa, Aa^Fpa, Aa^Fpa, Aa^Fpa, Aa^Fpa, Aa^Fpa, Aa^Fpa, Aa^Fpa, Aa, Aa, Aa^Fpa, Aa^Fpa, Aa^Fpa, Aa^Fpa, Aa^Fpa, Aa^Fpa, Aa^Fpa, Aa
Aa, Aa^Fpa, Aa^Fpa, Aa^Vha, Rb^Gvs, Rb^Gvs, Aa, Ha, Aa, Aa, Aa^Fpa, Aa^Fpa, Aa^Fpa, Aa^Fpa, Aa^Fpa, Aa^Fpa, Aa^Fpa, Aa, Aa, Rb, Rb, Aa, Aa, Aa, Aa^Fpa, Aa^Fpa, Aa^Fpa, Aa^Fpa, Aa^Fpa, Aa^Fpa, Aa^Fpa, Aa, Aa, Aa, Aa^Fpa, Aa^Fpa, Aa^Fpa, Aa^Fpa, Aa^Fpa, Aa^Fpa, Aa^Fpa, Aa
Aa, Aa^Fpa, Aa^Fpa, Rb^Gvs, Rb^Gvs, Rb^Gvs, Rb, Rb^Gvs, Aa, Rb, Rb, Ha, Aa^Fpa, Rb, Aa, Aa^Fpa, Aa, Aa, Aa, Rb, Rb, Aa, Aa, Aa, Aa^Fpa, Aa^Fpa, Aa^Fpa, Aa^Fpa, Aa^Fpa, Aa^Fpa, Aa^Fpa, Aa, Aa^Fpa, Aa^Fpa, Aa, Aa^Fpa, Aa^Fpa, Aa^Fpa, Aa, Aa^Vha, Aa^Fpa, Aa
Aa, Aa^Fpa, Aa^Fpa, Aa, Rb^Gvs, Aa, Rb^Gvs, Aa, Aa^Fpa, Ha, Aa, Aa, Aa^Fpa, Aa^Fpa, Aa^Fpa, Aa^Fpa, Aa, Aa, Aa, Rb, Rb, Aa, Aa, Aa^Fpa, Aa^Fpa, Aa^Fpa, Aa^Fpa, Aa^Fpa, Aa^Fpa, Aa^Fpa, Aa^Fpa, Aa, Aa^Vha, Aa^Fpa, Aa^Fpa, Aa^Fpa, Aa, Aa, Aa^Fpa, Aa^Fpa, Aa^Fpa, Aa
Aa, Aa^Fpa, Aa^Fpa, Aa, Rb^Gvs, Rb^Gvs, Aa, Aa^Fpa, Aa^Fpa, Aa^Fpa, Aa^Fpa, Aa^Fpa, Aa^Fpa, Aa^Fpa, Aa^Fpa, Ha, Aa, Aa, Aa, Rb, Rb, Aa, Aa, Aa^Fpa, Aa^Fpa, Aa^Fpa, Aa^Fpa, Aa^Fpa, Aa^Fpa, Aa^Fpa, Aa^Fpa, Aa, Aa, Aa, Aa^Fpa, Aa^Fpa, Aa^Fpa, Aa^Fpa, Aa^Fpa, Aa^Fpa, Aa^Fpa, Aa
Aa, Aa^Fpa, Aa^Fpa, Aa, Rb^Gvs, Aa^Fpa, Aa, Aa, Aa, Aa^Fpa, Aa^Fpa, Aa^Fpa, Aa^Fpa, Aa^Fpa, Aa^Fpa, Aa^Fpa, Aa, Aa, Aa, Rb, Rb, Aa, Aa, Aa^Fpa, Aa^Fpa, Aa^Fpa, Aa^Fpa, Aa^Fpa, Aa^Fpa, Aa^Fpa, Aa^Fpa, Aa, Aa, Aa, Aa^Fpa, Aa^Fpa, Tyb, Aa^Fpa, Aa, Aa, Aa, Aa
Aa, Aa^Fpa, Aa^Fpa, Aa^Fpa, Rb^Gvs, Aa, Rb^Gvs, Aa^Fpa, Aa^Fpa, Aa^Fpa, Aa^Fpa, Aa^Vha, Aa^Fpa, Aa^Fpa, Aa^Fpa, Aa^Fpa, Aa, Aa, Rrc^Vhca, Rr, Rb, Aa, Aa, Aa, Aa^Fpa, Aa^Fpa, Aa^Fpa, Aa^Fpa, Aa^Fpa, Aa^Fpa, Aa^Fpa, Aa^Fpa, Aa, Aa^Fpa, Aa^Fpa, Aa^Fpa, Tyb, Tyb, Tyb, Aa, Aa, Aa
Aa, Aa^Fpa, Aa^Fpa, Aa^Fpa, Aa^Fpa, Rb^Gvs, Rb^Gvs, Aa, Aa, Aa, Aa, Aa, Aa, Aa^Fpa, Aa^Fpa, Aa^Fpa, Aa, Aa, Aa, Rr, Rb, Aa, Aa, Aa, Aa^Fpa, Aa^Fpa, Aa^Fpa, Aa^Fpa, Aa^Fpa, Aa^Fpa, Aa^Fpa, Aa^Fpa, Aa, Aa, Aa^Fpa, Aa^Fpa, Aa^Fpa, Aa^Fpa, Aa^Fpa, Aa, Aa, Aa
Aa, Aa^Fpa, Aa^Fpa, Aa^Fpa, Aa^Fpa, Aa^Fpa, Aa, Aa, Aa, Aa, Aa, Aa, Aa, Aa^Fpa, Aa^Fpa, Aa^Fpa, Aa, Aa, Aa, Rb, Rb, Aa, Aa, Aa, Aa^Fpa, Aa^Fpa, Aa^Fpa, Aa^Fpa, Aa^Fpa, Aa^Fpa, Aa^Fpa, Aa^Fpa, Aa^Fpa, Aa^Fpa, Aa^Fpa, Aa^Fpa, Aa, Aa^Fpa, Aa, Aa^Fpa, Aa^Fpa, Aa
Aa, Aa^Fpa, Aa^Fpa, Aa^Fpa, Aa^Fpa, Aa^Vha, Aa, Aa, Aa, Aa, Aa, Aa, Aa, Aa^Fpa, Aa^Fpa, Aa^Fpa, Cea, Cea, Aa, Rb, Rb, Rb, Aa, Aa, Aa^Fpa, Aa^Fpa, Aa^Fpa, Aa, Aa, Aa^Fpa, Aa^Fpa, Aa^Fpa, Aa, Aa, Aa, Aa, Aa, Aa, Aa^Vha, Aa^Fpa, Aa^Fpa, Aa
Aa, Aa^Fpa, Aa^Fpa, Aa^Fpa, Aa^Fpa, Aa, Aa, Aa, Aa, Aa, Aa, Aa, Aa^Fpa, Aa, Cea, Cea, Cea, Cea, Aa, Rb, Rb, Rb, Aa, Aa, Aa^Fpa, Aa, Aa^Fpa, Aa^Fpa, Aa^Fpa, Aa^Fpa, Aa^Vha, Aa, Aa, Aa, Aa, Aa, Aa, Aa, Aa, Aa, Aa^Fpa, Aa
Aa, Aa^Fpa, Aa^Fpa, Aa^Fpa, Aa^Fpa, Aa^Fpa, Aa^Fpa, Aa, Aa, Aa, Aa^Fpa, Aa^Fpa, Aa^Fpa, Aa^Fpa, Aa^Fpa, Cea, Aa, Aa, Aa, Rb, Rb, Rb, Aa, Aa, Aa^Fpa, Aa^Fpa, Aa^Fpa, Aa^Fpa, Aa^Fpa, Aa^Fpa, Aa^Fpa, Aa, Aa, Aa, Aa, Aa, Aa, Aa, Aa, Aa, Aa^Fpa, Aa
Aa, Aa^Fpa, Aa^Fpa, Aa^Fpa, Aa^Fpa, Aa^Fpa, Aa^Fpa, Aa^Fpa, Aa^Fpa, Aa^Fpa, Aa^Fpa, Aa^Fpa, Aa^Fpa, Aa^Fpa, Aa^Fpa, Aa^Fpa, Aa, Aa, Aa, Rb, Rb, Aa, Aa, Aa, Aa^Fpa, Aa^Fpa, Aa^Fpa, Aa^Fpa, Aa^Fpa, Aa^Fpa, Aa^Fpa, Aa, Aa, Aa, Aa, Aa, Aa, Aa, Aa, Aa, Aa^Fpa, Aa
Aa, Aa^Fpa, Aa^Fpa, Aa^Fpa, Aa^Fpa, Aa^Fpa, Aa^Fpa, Aa^Fpa, Aa^Fpa, Aa^Fpa, Aa^Fpa, Aa^Fpa, Aa^Fpa, Aa^Fpa, Aa^Fpa, Aa^Fpa, Aa, Aa, Aa, Rb, Rb, Aa, Aa, Aa, Aa, Aa^Fpa, Aa^Fpa, Aa^Fpa, Aa^Fpa, Aa^Fpa, Aa^Fpa, Aa, Aa, Aa, Aa, Aa, Aa^Fpa, Aa, Aa^Fpa, Aa^Fpa, Aa^Fpa, Aa
Aa, Aa, Aa, Aa, Aa, Aa, Aa, Aa, Aa, Aa, Aa, Aa, Aa, Aa, Aa, Aa, Aa, Aa, Aa, Rb, Rb, Rb, Aa, Aa, Aa, Aa, Aa, Aa, Aa, Aa, Aa, Aa, Aa, Aa, Aa, Aa, Aa, Aa, Aa, Aa, Aa, Aa
