Xuc, Xu, Xuc, Xu, Xuc, Xu, Xuc, Xu, Xu, Xu, Xu, Xu, Xu, Xu, Xu, Xu, Xuc, Xu, Xu, Xu, Xu, Xu, Xu, Xu, Qxu, Qxu, Qxu, Qxu, Qxu, Qxu, Qxu, Xu, Xu, Xu, Xu, Xu, Rp, Ur, Isa, Rp, Isa, Urb
Uu, Xuc^Efs, Tb^Tf, Xuc, Ce^Em, Xuc, Uu, Xu, Tb^Tf, Xu, Xu, Xu, Xu, Xu, Uu, Xu, Uu, Xuc, Uu^Vu, Xu, Uu^Vu, Xu, Xu, Qxu, Qxu, Qxu, Qxu, Qxu, Qxu, Qxu, Cte, Xu, Xu, Xu, Xos, Xos, Rr^Pr\, Rr, Rp, Rp, Isa, Isa
Uu, Uu^Em, Urb^Tf, Uu^Tf, 1 Ke, Ce, Uu^Br\, Uu^Em, Urb^Em, Uu^Tf, Uu^Em, Uu, Urb^Br/, Uu^Br\, Uu^Br\, Uu, Uu^Es, Uu^Es, Uh^Es, Uu^Es, Uu^Dr, Xu, Uu^Qhu, Qxu, Uu^Qhu, Uh, Qxu^Bp\, Uh, Uu, Qxu, Ur, Kte, Xu, Xu, Rp, Isa, Rp, Rr^Pr\, Ias^Pr\o, Isa, Rp, Rr
Uu^Br\, Uu, Uu^Br/, Urb^Br/, Ce, Ce, Ur, Urb^Br\, Urb^Br\, Uu^Em, Urb^Br/, Urb^Br/, Uu, Urb, Urb, Urb^Br\, Uu^Br\, Uu^Es, Uu^Br/, Uu^Dr, Xuc, Xu, Uu^Qhu, Uh^Qhu, Uu^Qhu, Uu, Qxu, Uu, Uu, Uu^Vu, Ur, Uh, Xu, Xu, Ur, Rp, Ur, Isa, Rr, Rr^Pr\, Isa^Pr\o, Isa
Uu, Uu^Br\, Uu, Uu^Em, Ce, Ce, Uu, Uu, Xu, Uu^Br/, Xu, Uu, Xu, Xuc, Xuc, Urb, Ur^Es, Uu^Br/, Uu^Dr, Uh^Es, Xu, Uu^Qhu, Uu^Edt, Uh, Uu^Vu, Uu, Uu, Qxu, Uu, Uu, Uh, Qxu, Xu, Uu^Vu, Uu, Ur, Ur^Edb, Rp, Ur, Isa, Rr, Rr^Pr\
Xuc, Xuc, Xu, Xuc, Xu, Xuc, Xur, Xu, Uu^Vu, Xur, Uu, Xu, Uu^Vu, Xuc, Uu, Rr^Pw\o, Rr^Pw\o, Uu^Es, Xuc, Xu, Uu^Vu, Uu, Rb^Edt, Uu^Edt, Uu^Edt, Uu, Qxu, Qxu^Bp\, Uu^Edt, Uu^Edt, Uu, Uh, Xu, Uu, Uu^Edb, Ur^Edb, Uu^Edb, Ur^Edb, Ur^Edb, Rp, Rp, Rp
Xu, Xu, 2 Ker, Xuc, Cer, Uu, Uu, Uu, Uu, Uu, Uu, Uu, Uu, Uu, Ur, Ur, Xuc, Xuc, Xuc, Xu, Uu, Uu, Uh, Uh^Edt, Uu^Edt, Uu, Qxu^Bp\, Uu^Edt, Ur^Edt, Rb^Edt, Xu, Xu, Xot^Efs, Uu, Ur^Edb, Uu^Edb, Uu^Edb, Rb^Edb, Uu, Ur, Ur, Ur
Xu, Xu, Cer, Cer, Uu, Uu, Rb, Rb^Em, Uu, Uu, Rb, Uu, Ur, Ur, Uu, Xuc, Xu, Xu, Rb, Uu, Uu, Uh, Uh, Uu^Edt, Uu, Qxu, Qxu, Uu^Edt, Ur^Edt, Uu^Edt, Xu, Xot^Efs, Uu, Uu, Uu, Uu^Edb, 3 Kay, Isa, Uu, Uu^Vu, Xos, Xos
Xu, Xu, Uu, Uu, Uu^Vu, Uu, Uu, Rb, Rb^Em, Ur, Ur, Ur, Uu, Uu, Xu, Xu, Rb^Qhu, Rb, Uu, Uu, Uu, Uu, Uu, Uu, Qxu, Qxu, Uu, Uu, Uu, Uu, Xu, Xu, Uu, Uu, Cer, Cay, Cay, Cay, Cer, Uu, Xu, Xu
Xu, Xuc, Uu, Uu, Uh, Uh, Uu, Urb, Urb, Rb, Uu, Uu, Xu, Xu, Xuc, Uu^Qhu, Uu^Qhu, Uu^Qhu, Qxu, Uu, Uu, Uu, Qxu, Qxu, Uu, Uu, Rb, Uu, Uu^Vu, Xu, Xu, Uu^Vu, Uu, Uu^Edt, Isa, Iwo, Cer, Iwo, Uu, Uu, Xu, Xu
Xu, Uu, Uu, Uu, Uu, Uu, Urb, Rb, Uu, Uu, Xu, Xu, Uu^Vu, Xu, Uu^Qhu, Uu^Qhu, Uu^Qhu, Uu^Qhu, Qxu, Qxu, Qxu, Qxu, Qxu, Uh, Uu, Ur, Uu, Uu, Xu, Xu, Uu, Uu, Uu^Edb, Uu^Edb, Ur^Edb, Uu, Uu, Uu^Edb, Uu^Edb, Uu^Edb, Xu, Xu
Xu, Xu, Xur, Uu^Em, Rb, Urb, Urb, Uu, Xu, Xu, Uu, Uu, Rb, Rb, Uu^Qhu, Uu^Qhu, Uu^Qhu, Uu, Qxu, Uu, Uu, Qxu, Uu, Uu, Uu, Ur, Uu, Xu, Uh, Uh, Uh, Uu^Edb, Uu^Edb, Uu^Edb, Isa^Edb, Uu^Edb, Uu^Edb, Uu, Ur^Edb, Uu^Edb, Xu, Xu
Xu, Xur, Uu, Uu, Uu^Es, Ur, Uu, Uu^Vu, Xu, Uu^Vu, Uu, Rb, Uu, Uu, Qxu, Qxu, Qxu, Uh, Qxu, Uu, Qxu, Qxu, Uu, Uu, Uh, Uu, Xu, Xu, Uu, Uh, Uu, Uu, Uu, Uu^Edb, Ur, Uu^Edb, Xot^Edb, Xu, Ur, Uu^Edb, Xos, Xu
Xu, Xu, Uu^Vu, Uu, Uu, Ur, Uh^Qhh, Xuc, Uu, Uu, Uu, Uu, Uu, Qxu, Uu, Qxu, Uu, Qxu, Qxu, Qxu, Uu, Uu, Uu, Uh, Uh, Uu, Xu, Uu^Vu, Uu, Uu, Isa, Uu^Em, Ur, Cer, Uu, Isa, Isa, Uu, Rb, Uu, Xu, Xu
Xu, Xu, Xu, Uu, Uh^Qhh, Uh^Qhh, Uh^Qhh, Uu, Uu, Uu, Rb^Es, Uu, Uu, Qxu, Qxu, Qxu, Qxu, Qxu, Uu, Uu, Rb, Rb, Uu, Uu, Xu, Xu, Xot^Efs, Uu, Uu, Isa, Ur, Ur, Uu, Uu, Uu^Em, Uu, Xu, Xu, Rb, Uu, Xos, Xu
Xu, Xu, Uh, Xuc, Uu, Uu^Qhh, Uu, Ur, Ur, Ur, Ur, Uu, Qxu^Bp\, Qxu, Uu, Uu, Uu, Uu, Uu^Dr, Uu, Uu, Uu, Uu^Vu, Xu, Tb^Tf, Isa, Isa, Isa, Uu, Rb, Ur^Em, Ur, Uu^Em, Uu^Em, Uu^Em, Tb^Tf, Xu, Xos, Isa, Isa, Xu, Xu
Qxu, Xu, Qxu, Uu, Uu, Uu, Uu, Uu, Uu, Ur, Qxu, Qxu^Bp\, Qxu^Bp\, Ur, Ur, Ur, Ur, Ur, Ur, Uu, Ur, Uu, Xuc, Xu, Uu^Edt, Uu^Edt, Ur^Edt, Uu^Vu, Uu, Ur, Uu, Uu^Dr, Uu, Uu, Xot^Edb, Xot, Uu^Vu, Uu^Vu, Isa, Isa, Xu, Xu
Qxu, Qxu, Qxu, Qxu, Qxu, Qxu, Qxu, Qxu, Qxu, Qxu, Uu, Qxu, Uh, Uu, Uu, Uu^Dr, Uu, Uu, Uu, Ur, Uu, Ur, Ur, Ur, Ur^Edt, Ur^Edt, Uu^Edt, Ur, Uu, Uu, Uu, Uu^Em, Isa, Xot^Efs, Isa, Xot^Edb, Xot^Edb, Uu, Xu, Xu, Xu, Xu
Uu, Qxu, Uu, Qxu, Qxu, Qxu, Uu, Qxu, Qxu, Uu, Uu, Qxu, Qxu, Uu, Qxu, Uu, Qxu, Uh, Qxu, Uu, Uu^Em, Uu, Uu, Uu, Uh, Uu, Uu^Em, Uu, Uu, Cer, Uu, Uu, Uu^Em, Isa, Isa, Isa, Xos, Xu, Xu, Xu, Xu, Xu
Uu, Uu, Uu, Uu, Uu, Qxu, Qxu, Qxu, Qxu, Qxu, Qxu, Qxu, Qxu, Qxu, Qxu, Qxu, Qxu, Qxu, Qxu, Qxu, Qxu, Qxu, Qxu, Uh, Qxu, Uh, Qxu, Uu, Qxu, Uu, Uu, Uu, Uu, Uu, Qxu, Xuc, Qxu, Qxu, Qxu, Qxu, Qxu, Qxu
Uu, Uu, Qxu, Uu, Qxu, Qxu, Qxu, Qxu, Qxu, Qxu, Qxu, Qxu, Qxu, Qxu, Qxu, Qxu, Qxu, Qxu, Qxu, Qxu, Qxu, Qxu, Qxu, Qxu, Qxu, Qxu, Qxu, Qxu, Qxu, Qxu, Qxu, Qxu, Qxu, Qxu, Qxu, Qxu, Qxu, Qxu, Qxu, Qxu, Qxu, Qxu
Qxu, Qxu, Qxu, Qxu, Qxu, Qxu, Qxu, Qxu, Qxu, Qxu, Qxu, Qxu, Qxu, Qxu, Qxu, Qxu, Qxu, Qxu, Qxu, Qxu, Qxu, Qxu, Qxu, Qxu, Qxu, Qxu, Qxu, Qxu, Qxu, Qxu, Qxu, Qxu, Qxu, Qxu, Qxu, Qxu, Qxu, Qxu, Qxu, Qxu, Qxu, Qxu
