Xuc, Xu, Xuc, Xu, Xuc, Xu, Xuc, Xu, Xuc, Xu, Xu, Xu, Xu, Xu, Xu, Xu, Xuc, Xu, Xu, Xu, Xu, Xu, Xu, Xu, Qxu, Qxu, Qxu, Qxu, Qxu, Qxu, Qxu, Xu, Xu, Xu, Xu, Xu, Rp, Ur, Rp, Rp, Ur, Urb
Uu, Xuc^Efs, Uu^Uf, Xuc, Ce, Xuc, Uu, Xuc, Uu^Uf, Xuc, Xuc, Xu, Xu, Xu, Uu, Xu, Uu, Xuc, Uu^Vu, Xu, Uu^Vu, Xu, Xu, Qxu, Qxu, Qxu, Qxu, Qxu, Qxu, Qxu, Cte, Xu, Xu, Xu, Xos, Xos, Rr^Pr\, Rr, Rp, Rp, Ur, Ur
Uu, Uu, Urb, Uu, 1 Ke, Ce, Uu^Br\, Uu, Urb, Uu, Uu, Uu, Urb^Br/, Uu^Br\, Uu^Br\, Uu, Uu^Es, Uu^Es, Uh^Es, Uu^Es, Uu^Dr, Xu, Uu, Qxu, Uu, Uh, Qxu^Bp\, Uh, Uu, Qxu, Ur, Kte, Xu, Xu, Rp, Rr, Rp, Rr^Pr\, Rr^Pr\o, Ur, Rp, Rr
Uu^Br\, Uu, Uu^Br/, Urb^Br/, Ce, Ce, Ur, Urb^Br\, Urb^Br\, Uu^Es, Urb^Br/, Urb^Br/, Uu, Urb, Urb, Urb^Br\, Uu^Br\, Uu^Es, Uu^Br/, Uu^Dr, Xuc, Xu, Uu, Uh, Uu, Uu, Qxu, Uu, Uu, Uu^Vu, Ur, Uh, Xu, Xu, Ur, Rp, Ur, Rr, Rr, Rr^Pr\, Rr^Pr\o, Rp
Uu, Uu^Br\, Uu, Uu, Ce, Ce, Uu, Uu, Xu, Uu^Br/, Xu, Uu, Xu, Xuc, Xuc, Urb, Ur^Es, Uu^Br/, Uu^Dr, Uh^Es, Xu, Uu, Uu^Edt, Uh, Uu^Vu, Uu, Uu, Qxu, Uu, Uu, Uh, Qxu, Xu, Uu^Vu, Uu, Ur, Ur^Edb, Rp, Ur, Rp, Rr, Rr^Pr\
Xuc, Xuc, Xu, Xuc, Xu, Xuc, Xu, Xu, Uu^Vu, Xu, Uu, Xu, Uu^Vu, Xuc, Uu, Rr^Pw\o, Rr^Pw\o, Uu^Es, Xuc, Xu, Uu^Vu, Uu, Rb^Edt, Uu^Edt, Uu^Edt, Uu, Qxu, Qxu^Bp\, Uu^Edt, Uu^Edt, Uu, Uh, Xu, Uu, Uu^Edb, Ur^Edb, Uu^Edb, Ur^Edb, Ur^Edb, Rp, Rp, Rp
Xu, Xu, 2 Ker, Xuc, Cer, Uu, Uu, Uu, Uu, Uu, Uu, Uu, Uu, Uu, Ur, Ur, Xuc, Xuc, Xuc, Xu, Uu, Uu, Uh, Uh^Edt, Uu^Edt, Uu, Qxu^Bp\, Uu^Edt, Ur^Edt, Rb^Edt, Uu^Edt, Xu, Xu, Uu, Ur^Edb, Uu^Edb, Uu^Edb, Rb^Edb, Uu, Ur, Ur, Ur
Xu, Xu, Cer, Cer, Uu, Uu, Rb, Rb, Uu, Uu, Rb, Uu, Ur, Ur, Uu, Xuc, Xu, Xu, Rb, Uu, Uu, Uh, Uh, Uu^Edt, Uu, Qxu, Qxu, Uu^Edt, Ur^Edt, Uu^Edt, Xu, Xu, Uu, Uu, Uu, Uu^Edb, 3 Kay, Ior, Uu, Uu^Vu, Xos, Xos
Xu, Xu, Uu, Uu, Uu^Vu, Uu, Uu, Rb, Rb, Ur, Ur, Ur, Uu, Uu, Xu, Xu, Rb, Rb, Uu, Uu, Uu, Uu, Uu, Uu, Qxu, Qxu, Uu, Uu, Uu, Uu, Xu, Xu, Uu, Uu, Cer, Cay, Cay, Cay, Cer, Uu, Xu, Xu
Xu, Xuc, Uu, Uu, Uh, Uh, Uu, Urb, Urb, Rb, Uu, Uu, Xu, Xu, Xuc, Uu, Uu, Uu, Qxu, Uu, Uu, Uu, Qxu, Qxu, Uu, Uu, Rb, Uu, Uu^Vu, Xu, Xu, Uu^Vu, Uu, Uu, Ur, Ior, Cer, Ior, Uu, Uu, Xu, Xu
Xu, Xu, Uu, Uu, Uu, Uu, Urb, Rb, Uu, Uu, Xu, Xu, Uu^Vu, Xu, Uu, Uu, Uu^Es, Uu, Qxu, Qxu, Qxu, Qxu, Qxu, Uh, Uu, Ur, Uu, Uu, Xu, Xu, Uu, Uu, Uu^Edb, Uu^Edb, Ur^Edb, Uu, Uu, Uu, Uu, Uu, Xu, Xu
Xu, Xu, Uu, Uu, Rb, Urb, Urb, Uu, Xu, Xu, Uu, Uu, Rb, Rb, Uu, Uu, Uu, Uu, Qxu, Qxu, Qxu, Qxu, Uu, Uu, Uu, Ur, Uu, Xu, Uh, Uh, Uh, Uu^Edb, Uu^Edb, Uu^Edb, Ur^Edb, Uu^Edb, Uu, Uu, Ur, Uu, Xu, Xu
Xu, Xu, Uu, Uu, Uu^Es, Ur, Uu, Uu^Vu, Xu, Uu^Vu, Uu, Rb, Uu, Uu, Qxu, Qxu, Qxu, Uh, Qxu, Qxu, Qxu, Qxu, Uu, Uu, Uh, Uu, Xu, Xu, Uu, Uh, Uu, Uu, Uu, Uu, Ur, Uu^Edb, Uu, Xu, Ur, Uu, Xu, Xu
Xu, Xu, Uu^Vu, Uu, Uu, Ur, Uh, Xuc, Uu, Uu, Uu, Uu, Uu, Qxu, Qxu, Qxu, Qxu, Qxu, Qxu, Qxu, Uu, Uu, Uu, Uh, Uh, Uu, Xu, Uu^Vu, Uu, Uu, Uu, Uu, Ur, Cer, Uu, Uu, Uu, Uu, Rb, Uu, Xu, Xu
Xu, Xu, Xu, Uu, Uh, Uh, Uh, Uu, Uu, Uu, Rb^Es, Uu, Uu, Qxu, Qxu, Qxu, Qxu, Qxu, Uu, Uu, Rb, Rb, Uu, Uu, Xu, Xu, Uu, Uu, Uu, Uu^Es, Ur, Ur, Uu, Uu, Uu, Uu, Xu, Xu, Rb, Uu, Xu, Xu
Xu, Xu, Uh, Xuc, Uu, Uu, Uu, Ur, Ur, Ur, Ur, Uu, Qxu^Bp\, Qxu, Uu, Uu, Uu, Uu, Uu, Uu, Uu, Uu, Uu^Vu, Xu, Uu, Uu, Uu, Uu, Uu, Rb, Ur, Ur, Uu, Uu^Em, Uu, Uu^Uf, Xu, Xu, Uu, Uu, Xu, Xu
Qxu, Xu, Qxu, Uu, Uu, Uu, Uu, Uu, Uu, Ur, Qxu, Qxu^Bp\, Qxu^Bp\, Ur, Ur, Ur, Ur, Ur, Ur, Uu, Ur, Uu, Xuc, Xu, Uu^Edt, Uu^Edt, Ur^Edt, Uu^Vu, Uu, Ur, Uu, Uu, Uu, Uu, Xuc, Xu, Uu^Vu, Uu^Vu, Uu, Uu, Xu, Xu
Qxu, Qxu, Qxu, Qxu, Qxu, Qxu, Qxu, Qxu, Qxu, Qxu, Qxu, Qxu, Uh, Uu, Uu, Uu, Uu, Uu, Uu, Ur, Uu, Ur, Ur, Ur, Ur^Edt, Ur^Edt, Uu^Edt, Ur, Uu, Uu, Uu, Uu, Uu, Xuc, Uu, Xuc, Xuc, Uu, Xu, Xu, Xu, Xu
Qxu, Qxu, Qxu, Qxu, Qxu, Qxu, Qxu, Qxu, Qxu, Qxu, Qxu, Qxu, Qxu, Uu, Qxu, Uu, Qxu, Uh, Qxu, Uu, Uu^Em, Uu, Uu, Uu, Uh, Uu, Uu^Em, Uu, Uu, Cer, Uu, Uu, Uu^Em, Uu, Uu, Uu, Xuc, Xu, Xu, Xu, Xu, Xu
Qxu, Qxu, Qxu, Qxu, Qxu, Qxu, Qxu, Qxu, Qxu, Qxu, Qxu, Qxu, Qxu, Qxu, Qxu, Qxu, Qxu, Qxu, Qxu, Qxu, Qxu, Qxu, Qxu, Uh, Qxu, Uh, Qxu, Uu, Qxu, Uu, Uu, Uu, Uu, Uu, Qxu, Xuc, Qxu, Qxu, Qxu, Qxu, Qxu, Qxu
Qxu, Qxu, Qxu, Qxu, Qxu, Qxu, Qxu, Qxu, Qxu, Qxu, Qxu, Qxu, Qxu, Qxu, Qxu, Qxu, Qxu, Qxu, Qxu, Qxu, Qxu, Qxu, Qxu, Qxu, Qxu, Qxu, Qxu, Qxu, Qxu, Qxu, Qxu, Qxu, Qxu, Qxu, Qxu, Qxu, Qxu, Qxu, Qxu, Qxu, Qxu, Qxu
Qxu, Qxu, Qxu, Qxu, Qxu, Qxu, Qxu, Qxu, Qxu, Qxu, Qxu, Qxu, Qxu, Qxu, Qxu, Qxu, Qxu, Qxu, Qxu, Qxu, Qxu, Qxu, Qxu, Qxu, Qxu, Qxu, Qxu, Qxu, Qxu, Qxu, Qxu, Qxu, Qxu, Qxu, Qxu, Qxu, Qxu, Qxu, Qxu, Qxu, Qxu, Qxu
