Aa, Aa, Aa, Aa, Rra, Rra, Rra, Rra, Rra, Aa, Aa, Aa, Ai, Ai, Ai, Ai, Sm, Ss, Ss, Ss, Ss, Ss, Ai, Ai, Aa, Ai, Ai, Ai, Ai
Aa, Aa, Aa, Aa, Aa, Rra, Rra, Rra, Rra, Aa^Esa, Ai, Ai, Ai, Ai, Ai, Ai, Sm, Wwf, Cea, Ss, Ior, Ss, Cea, Aa, 2 Kea, Ai, Sm, Ai, Ss
Aa, Aa, Aa, Aa^Vca, Aa^Fpa, Aa^Fpa, Aa, Rra, Rra, Rra, Rp, Rp, Sm, Ai, Cea, Cea^Esa, Cea, Cea, Wwg, Ior, Rp, Ior, Aa, Cea, Cea, Cea, Cea, Sm, Sm
Aa, Aa, Aa, Aa^Fma, Aa, Aa^Fpa, Aa, Re, Rr, Rr, Rp, Sm, Ss, Ss, Ior, Ior, Wwf, Wwf, Rp, Aa, Rp^Qov, Rp, Ai, Aa, Ior, Ior, Sm, Sm, Ss
Aa, Aa^Esa, Aa, Aa, Aa^Fpa, Aa, Aa, Rb, Re, Rp, Rp, Ss, Ss, Ior^Esd, Ior, Rp, Wwf, Wwg, Rp, Rp^Qov, Iwr^Ltz, Rp^Qov, Rp, Wwf, Wwf, Ior, Rp^Esa, Sm, Cea
Aa, Aa, Aa, Aa, Aa^Fpa, Aa^Fpa, Aa, Rb^Esa, Rb, Rb, Aa, Wwf, Aa, Cea, Wwf, Wwf, Rp, Rp, Rp, Rp^Qov, Rp^Qov, Rp^Qov, Wwf, Wwg, Wwf, Aa, Aa, Rp, Cea
Aa, Aa, Aa, Aa, Aa, Aa^Feta, Aa, Aa, Aa, Aa^Vaa, Ai, Ss, Ss, Cea^Esa, Ss, Ior, Aa, Rp, Wwf, Rp, Rp, Rp, Wwf, Wwf, Ior, Wwg, Ai, Rp, Cea
Aa, Aa, Aa^Fma, Aa, Aa, Aa, Aa^Esa, Aa, Aa, Ai^Esa, Ai, Sm, Ai, Cea, Cea, Ss, Aa^Esa, Aa, Sm, Sm, Rp, Ss, Ss, Ss, Wwf, Wwg, Wwg, Rp, Cea
Aa^Fpa, Aa^Fpa, Aa^Fpa, Aa, Aa, Aa, Aa, Aa, Aa, Ss, Ai, Ai, Ss, Ss, Ior, Ss, Ss, Ss, Aa, Ss, Rp, Ss, Ior, Ss, Wwf, Ai, Ior, Rp, Cea
Aa, Aa^Fpa, Aa, Aa, Aa, Aa, Wwf, Wwf, Wwf, Aa, Wwf, Wwf, Ss, Ss, Ior, Ior^Esa, Cea^Esd, Ior, Cea, Rp, Rp, Rp, Wwf, Rp, Ior, Rp^Esa, Wwf, Cea, Ss
Aa, Aa, Aa, Aa, Aa, Aa, Aa, Wwf, Aa^Fpa, Aa^Fma, Aa, Sm, Ss, Sm, Wwf, Ss, Ss, Cea, Ss, Cea, Cea, Cea, Cea, Cea, Ss, Ior, Sm, Wwf, Aa
Aa, Aa, Rb, Aa, Wwf, Wwf, Wwf, Aa^Fma, Aa^Fpa, Aa^Fpa, Aa, Ai, Ai, Ss, Wwf, Ss, Wwf, Ai, Aa, Ss, Ai, Ai, Wwf, Wwf, Ss, Sm, Wwf, Ai, Aa
Rb, Rb, Rb, Rb, Re, Re, Re^Eff, Aa, Aa, Aa, Aa, Ai, Ai, Ss, Sm, Sm, Ai, Aa, Ss, Aa^Vca, Ai, Ai, Ai, Ai, Ss, Ss, Ai, Ai, Aa
Rb, Ce, Ce, Rb, Rb, Re^Eff, Gd^Vh, Re^Eff, Re^Eff, Aa, Aa^Esa, Ss, Ss, Ss, Ai, Ai, Ai, Sm, Sm, Aa, Aa, Ai, Ai, Ai^Esa, Aa, Ai, Aa^Vla, Aa, Aa
Rb, 1 Ke, Ce, Ce, Rb, Gd^Eff, Gd^Eff, Gd^Eff, Aa, Aa, Aa, Ss, Ss, Ss, Ss, Aa, Aa, Ai, Ai, Ai, Aa, Aa^Fma, Wwf, Aa, Aa^Fma, Aa^Fma, Aa, Aa, Aa
Rb, Ce, Re, Re, Re, Re, Re, Rb, Re, Aa, Aa, Ss, Ss, Ss, Aa^Fpa, Aa, Aa, Ss, Ai, Ai, Ai, Wwf, Ss, Wwf, Ss, Aa, Ai^Esa, Ai, Aa
Re, Re, Aa^Fpa, Re, Aa, Re, Wwf, Aa, Wwf, Wwf, Wwf, Aa, Aa^Fpa, Aa, Aa, Aa, Aa, Aa^Esa, Ai, Sm, Sm, Ss, Sm, Ss, Ss, Ai, Ai, Ai, Ai
Aa, Aa^Fpa, Aa^Fpa, Aa^Fpa, Aa, Aa, Aa, Aa, Aa, Ss, Ss, Aa^Fma, Aa^Fpa, Aa^Fpa, Aa, Ss, Ss, Ss, Ss, Sm, Sm, Ss, Wwf, Ss, Sm, Ss, Wwf, Ai, Aa
Aa, Aa, Aa^Fma, Aa^Fpa, Aa, Aa, Aa^Fpa, Aa^Fpa, Aa^Fpa, Ss, Wwf, Aa, Aa, Aa, Sm, Ss, Sm, Ss, Aa, Ss, Wwf, Wwf, Aa, Aa, Aa, Wwf, Wwf, Aa, Aa
Aa, Aa, Aa, Aa, Aa, Aa, Aa, Aa^Fpa, Aa, Wwf, Sm, Wwf, Sm, Wwf, Wwf, Sm, Aa, Aa^Fma, Aa, Aa, Sm, Aa^Esa, Aa, Aa^Vaa, Aa, Wwf, Sm, Wwf, Aa
Aa, Aa, Aa, Aa, Aa, Aa, Sm, Aa, Ai, Sm, Ss, Ss, Sm, Ai, Ai, Ai, Aa, Aa, Ss, Aa, Wwf, Wwf, Aa, Aa, Ss, Sm, Ce, Ai, Ai
Aa, Aa, Aa, Aa, Ss, Sm, Sm, Ai, Wwf, Ai, Sm, Ss, Sm, Ai, Sm, Wwf, Aa, Aa^Esa, Aa, Aa, Aa^Fma, Aa^Fpa, Wwf, Wwf, Ce, Ss, Ce, Wwf, Ai
Aa, Aa^Esa, Aa, Ss, Ss, Ss, Ss, Wwf, Aa^Fma, Aa, Aa, Sm, Ss, Sm, Ss, Wwf, Wwf, Aa, Aa^Vca, Aa, Aa, Aa^Fpa, Wwf, Cea, Cea, 3 Ket, Aa^Fpa, Ai, Ai
Aa, Aa, Aa, Aa, Aa, Ss, Aa^Fma, Aa^Fma, Aa^Feta, Aa^Fma, Sm, Ai, Sm, Ss, Ai, Aa, Aa, Wwf, Aa, Aa, Aa, Aa, Aa, Aa, Aa, Aa^Fpa, Aa, Aa^Esa, Wwf
Aa, Aa, Aa, Aa, Aa, Aa, Aa, Aa^Fma, Ai, Sm, Sm, Sm, Ai, Ai, Ai, Aa, Aa, Aa, Aa, Aa, Aa, Aa, Aa, Aa, Aa, Aa, Aa, Aa, Aa
