Xu, Xu, Xu, Xu, Qlf, Qlf, Qlf, Qlf, Qlf, Qlf, Uu, Uu, Uu, Uu, Uu, Uu, Uu, Uu, Uu, Qlf, Qlf, Qlf, Qlf, Qlf, Qlf, Qlf, Qlf, Qlf, Qlf, Qlf, Qlf, Qlf, Qlf, Qlf, Qlf, Qlf, Qlf, Qlf, Qlf, Qlf, Qlf, Qlf
Xu, Xu, Xu, Xu, Qlf, Qlf, Qlf, Qlf, Qlf, Qlf, Ql, Uu, Uu, Uu, Uu, Uu, Uu, Uu, Ql, Ql, Ql, Ql, Ql, Ql, Ql, Ql, Ql, Qlf, Ql, Ql, Ql, Ql, Ql, Ql, Ql, Qlf, Ql, Qlf, Qlf, Qlf, Qlf, Qlf
Xu, Xu, Xu, Xu, Qlf, Qlf, Qlf, Qlf, Ql, Ql, Ql, Ql, Ql, Uu, Uu, Uu, Uu, Uu, Ql, Ql, Ql, Ql, Ql, Ql, Ql, Ql, Ql, Ql, Ql, Ql, Ql, Ql, Ql, Ql, Ql, Ql, Ql, Ql, Ql, Qlf, Qlf, Qlf
Xu, Xu, Xu, Xu, Qlf, Qlf, Ql, Ql, Ql, Ql, Ql, Ql, Ql, Uu, Uu, Uu, Qxu, Qxu, Qxu, Qxu, Qxu, Qxu, Qxu, Qxu, Qxu, Qxu, Qxu, Qxu, Qxu, Qxu, Qxu, Qxu, Qxu, Ql, Ql, Ql, Ql, Ql, Ql, Qlf, Qlf, Qlf
Xu, Xu, Xu, Xu, Ql, Ql, Ql, Ql, Qxu, Ql, Ql, Ql, Qxu, Uu, Qxu, Qxu, Qxu, Qxu, Qxu, Qxu, Qxu, Qxu, Qxu, Qxu, Qxu, Qxu, Qxu, Qxu, Qxu, Qxu, Qxu, Qxu, Qxu, Qxu, Qxu, Ql, Ql, Ql, Ql, Qlf, Qlf, Qlf
Xu, Xu, Xu, Xu, Ql, Ql, Ql, Qxu, Qxu, Qxu, Qxu, Qxu, Qxu, Qxu, Qxu, Qxu, Qxu, Qxu, Qxu, Qxu, Qxu, Qxu, Qxu, Qxu, Uu, Qxu, Qxu, Qxu, Qxu, Qxu, Qxu, Qxu, Qxu, Qxu, Qxu, Qxu, Qxu, Ql, Ql, Ql, Qlf, Qlf
Xu, Xu, Xu, Xu, Ql, Ql, Qxu, Qxu, Qxu, Qxu, Qxu, Qxu, Qxu, Qxu, Uu, Qxu, Xu, Uu, Uu, Uu, Uu, Uu, Uu, Uu, Uu, Uu, Uu, Uu, Uu, Uu, Uu, Uu, Uu, Qxu, Qxu, Qxu, Qxu, Ql, Ql, Ql, Qlf, Qlf
Xu, Xu, Xu, Xu, Ql, Qxu, Qxu, Qxu, Qxu, Qxu, Uu, Uu, Uu, Uu, Uu, Xu, Xu, Xu, Urb, Urb, Urb, Urb, Urb, Urb, Urb, Urb, Urb, Urb, Urb, Urb, Urb, Uu, Uu, Uu, Qxu, Qxu, Qxu, Qxu, Ql, Ql, Qlf, Qlf
Xu, Xu, Xu, Xu, Ql, Qxu, Qxu, Qxu, Uu, Uu, Uu, Uu, Urb, Uu, Urb, Xu, Xu, Xu, Uu, Uu, Qxu, Qxu, Qxu, Qxu, Qxu, Qxu, Xu, Xu, Xu, Urb, Urb, Uu, Uu, Uu, Uu, Qxu, Qxu, Qxu, Ql, Ql, Qlf, Qlf
Xu, Xu, Xu, Xu, Ql, Qxu, Qxu, Qxu, Uu, Uu, Urb, Urb, Xu, Urb, Xu, Xu, Xu, Xu, Xu, Xu, Xu, Xu, Xu, Qxu, Xu, Xu, Xu, Xu, Xu, Uh, Uh, Urb, Urb, Uu, Xu, Qxu, Qxu, Qxu, Ql, Ql, Qlf, Qlf
Xu, Xu, Xu, Xu, Xu, Qxu, Qxu, Qxu, Uu, Uu, Urb, Urb, Xu, Xu, Xu, Xu, Xu, Xu, Xu, Xu, Xu, Xu, Cud, Xu, Cud, Xu, Xu, Xu, Xu, Xu, Xu, Uu, Urb, Uu, Xu, Xu, Qxu, Qxu, Ql, Ql, Qlf, Qlf
Xu, Xu, Xu, Xu, Xu, Qxu, Qxu, Qxu, Uu, Uu, Urb, Xu, Xu, Xu, Xu, Xu, Xu, Xu, Xu, Xu, Xu, Cud, Cud, Cud, Cud, Cud, Xu, Xu, Xu, Xu, Xu, Uu, Urb, Xu, Xu, Xu, Qxu, Qxu, Ql, Ql, Qlf, Qlf
Xu, Xu, Xu, Xu, Xu, Qxu, Qxu, Qxu, Uu, Urb, Xu, Xu, Xu, Xu, Xu, Xu, Xu, Xu, Xu, Xu, Xu, Cud, Cud, Cud, Cud, Cud, Xu, Xu, Xu, Xu, Uu, Urb, Urb, Uu, Uh, Xu, Qxu, Qxu, Ql, Ql, Qlf, Qlf
Xu, Xu, Xu, Xu, Xu, Xu, Qxu, Qxu, Uu, Urb, Xu, Xu, Xu, Xu, Xu, Xu, Xu, Xu, Xu, Xu, Xu, Xu, Uh, Urb, Uh, Xu, Xu, Xu, Xu, Uh, Uu, Urb, Uu, Uu, Uh, Qxu, Qxu, Qxu, Ql, Ql, Qlf, Qlf
Xu, Xu, Xu, Xu, Xu, Xu, Qxu, Qxu, Uu, Urb, Xu, Xu, Xu, Xu, Uu, Xu, Xu, Xu, Uu, Xu, Uh, Uh, Urb, Urb, Uh, Xu, Xu, Xu, Uh, Uh, Urb, Urb, Uu, Uu, Uu, Qxu, Qxu, Qxu, Ql, Ql, Qlf, Qlf
Xu, Xu, Xu, Xu, Xu, Xu, Qxu, Qxu, Uu, Urb, Xu, Xu, Xu, Uu, Uu, Xu, Xu, Xu, Uu, Uu, Urb, Urb, Urb, Uu, Uu, Xu, Xu, Uh, Uu, Uu, Urb, Uu, Uu, Uu, Uu, Qxu, Qxu, Qxu, Ql, Ql, Qlf, Qlf
Xu, Xu, Xu, Xu, Xu, Xu, Qxu, Qxu, Uu, Urb, Xu, Xu, Xu, Uu, Uu, Urb, Xu, Xu, Xu, Urb, Urb, Urb, Uh, Uh, Xu, Xu, Xu, Xu, Uu, Urb, Uu, Uu, Uh, Uh, Uu, Qxu, Qxu, Qxu, Ql, Ql, Qlf, Qlf
Xu, Xu, Xu, Xu, Xu, Xu, Qxu, Qxu, Xu, Xu, Xu, Xu, Xu, Uu, Uu, Urb, Xu, Xu, Xu, Uh, Uh, Uh, Xu, Xu, Xu, Xu, Xu, Uu^Vud, Uh, Urb, Uu, Uh, Uh, Uu, Qxu, Qxu, Qxu, Qxu, Ql, Ql, Qlf, Qlf
Uh, Xu, Xu, Xu, Xu, Qxu, Qxu, Qxu, Xu, Xu, Xu, Xu, Xu, Uh, Uu, Xu, Xu, Xu, Xu, Xu, Xu, Xu, Xu, Xu, Qxu, Qxu, Uh, Uh, Urb, Ur, Uu, Uh, Uu, Uu, Qxu, Qxu, Qxu, Ql, Ql, Ql, Qlf, Qlf
Ww, Uh, Uh, Xu, Xu, Qxu, Qxu, Qxu, Xu, Xu, Xu, Xu, Xu, Uh, Uh, Xu, Xu, Xu, Xu, Xu, Xu, Xu, Xu, Xu, Qxu, Qxu, Uu, Uu, Uu, Ur, Uu, Uu, Qxu, Qxu, Qxu, Qxu, Ql, Ql, Qlf, Qlf, Qlf, Qlf
Wwf, Uh, Wwg, Uh, Uh, Qxu, Qxu, Qxu, Xu, Xu, Xu, Xu, Xu, Xu, Uh, Xu, Xu, Xu, Uu, Xu, Xu, Uh, Uh, Qxu, Uu, Uu, Uu, Uu, Urb, Urb, Uu, Uu, Qxu, Qxu, Qxu, Ql, Ql, Ql, Qlf, Qlf, Qlf, Qlf
Wwf, Wwf, Wwf, Wwg, Wwf, Qxu, Qxu, Qxu, Xu, Xu, Xu, Xu, Xu, Uh, Xu, Xu, Xu, Xu, Xu, Xu, Xu, Xu, Qxu, Qxu, Qxu, Qxu, Qxu, Uu, Uu, Urb, Uu, Uu, Qxu, Qxu, Qxu, Ql, Ql, Ql, Qlf, Qlf, Xu, Xu
Uh, Wwf, Wwg, Wwf, Wwf, Qxu, Qxu, Qxu, Xu, Xu, Xu, Xu, Xu, Xu, Xu, Xu, Xu, Xu, Xu, Xu, Xu, Xu, Qxu, Qxu, Qxu, Qxu, Qxu, Uu, Uu, Ur, Uu, Uu, Qxu, Qxu, Qxu, Ql, Qlf, Qlf, Xu, Xu, Xu, Xu
Xu, Uh, Uh, Wwg, Uh, Qxu, Qxu, Qxu, Xu, Xu, Xu, Xu, Xu, Xu, Xu, Xu, Xu, Xu, Xu, Xu, Xu, Xu, Xu, Qxu, Qxu, Qxu, Xu, Uu, Cay, Ur, Uu, Uu, Qxu, Qxu, Qxu, Ql, Ql, Ql, Ql, Xu, Xu, Xu
Qlf, Xu, Qlf, Uh, Ql, Qxu, Qxu, Qxu, Uu, Xu, Xu, Xu, Xu, Xu, Xu, Xu, Xu, Xu, Xu, Xu, Xu, Xu, Xu, Xu, Qxu, Xu, Uu^Vu, Xoa, Isa, Isa, Xoa, Xoa, Qxu, Qxu, Qxu, Ql, Ql, Ql, Ql, Xu, Xu, Xu
Qlf, Qlf, Qlf, Ql, Ql, Qxu, Qxu, Qxu, Uu, Uu, Uu, Urb, Urb, Uu, Uu, Xu, Xu, Xu, Xu, Xu, Xu, Xu, Xu, Xu, Xu, Qxu, Uu, Isa, Isa, Uu, Uu, Xoa, Qxu, Qxu, Qxu, Ql, Ql, Ql, Xu, Xu, Xu, Xu
Qlf, Qlf, Qlf, Ql, Ql, Qxu, Qxu, Qxu, Qxu, Uu, Uu, Uu, Uu, Urb, Xu, Xu, Xu, Xu, Xu, Xu, Xu, Xu, Xu, Xu, Xu, Qxu, Urb, Uu, Ur, Uu, Uu, Uu, Qxu, Qxu, Qxu, Ql, Xu, Xu, Xu, Xu, Xu, Xu
Qlf, Qlf, Qlf, Ql, Ql, Qxu, Qxu, Qxu, Qxu, Qxu, Qxu, Uu, Uu, Uu, Xu, Xu, Xu, Xu, Xu, Xu, Xu, Xu, Xu, Xu, Xu, Qxu, Urb, Urb, Ur, Ur, Uu, Uu, Qxu, Qxu, Ql, Ql, Xu, Xu, Xu, Xu, Xu, Xu
Qlf, Qlf, Qlf, Ql, Ql, Ql, Ql, Qxu, Qxu, Qxu, Qxu, Qxu, Qxu, Uu, Xu, Xu, Xu, Xu, Xu, Xu, Xu, Xu, Xu, Xu, Xu, Xu, Urb, Urb, Urb, Urb, Uu, Qxu, Qxu, Qxu, Ql, Ql, Xu, Xu, Xu, Xu, Xu, Xu
Qlf, Qlf, Qlf, Ql, Ql, Ql, Ql, Ql, Ql, Qxu, Qxu, Qxu, Qxu, Qxu, Qxu, Xu, Xu, Xu, Xu, Xu, Xu, Xu, Xu, Xu, Uu, Uu, Ur, Urb, Urb, Uu, Uu, Qxu, Qxu, Qxu, Ql, Xu, Xu, Xu, Xu, Xu, Xu, Xu
Qlf, Qlf, Qlf, Ql, Ql, Ql, Ql, Ql, Ql, Ql, Ql, Qxu, Qxu, Qxu, Qxu, Qxu, Qxu, Xu, Xu, Xu, Xu, Xu, Xu, Xu, Cay, Uu, Urb, Urb, Urb, Uu, Cay, Qxu, Qxu, Qxu, Xu, Xu, Xu, Xu, Xu, Xu, Xu, Xu
Qlf, Qlf, Qlf, Qlf, Qlf, Qlf, Qlf, Ql, Ql, Ql, Ql, Ql, Ql, Qxu, Qxu, Qxu, Qxu, Xu, Xu, Xu, Xu, Xu, Xu, Xu, Xu, Cay, Uu, Urb, Uu, Cay, Cay, Qxu, Qxu, Qxu, Xu, Xu, Xu, Xu, Xu, Xu, Xu, Xu
Qlf, Qlf, Qlf, Qlf, Qlf, Qlf, Qlf, Qlf, Qlf, Qlf, Qlf, Ql, Ql, Ql, Xu, Qxu, Xu, Uu, Xu, Xu, Xu, Xu, Xu, Xu, Xoa, Cay, Uu, Urb, Uu, Cay, Xu, Cay, Xu, Xu, Xu, Xu, Xu, Xu, Xu, Xu, Xu, Xu
Qlf, Qlf, Qlf, Qlf, Qlf, Qlf, Xu, Qlf, Xu, Qlf, Xu, Qlf, Xu, Xu, Xu, Xu, Xu, Xu, Xu, Xu, Xu, Xu, Xu, Xoa, Isa, Uu, Urb, Urb, Xoa, Xu, Xu, Xu, Xu, Xu, Xu, Xu, Xu, Xu, Xu, Xu, Xu, Xu
Xu, Qlf, Xu, Xu, Xu, Xu, Xu, Xu, Xu, Xu, Xu, Xu, Xu, Xu, Xu, Xu, Xu, Xu, Xu, Xu, Xu, Xu, Uu^Vud, Uu, Uu, Uu, Urb, Uu, Xoa, Xu, Xu, Xu, Xu, Xu, Xu, Xu, Xu, Xu, Xu, Xu, Xu, Xu
Xu, Xu, Xu, Xu, Xu, Xu, Xu, Xu, Xoa, Xu, Xoa, Xu, Xu, Xu, Uh, Xu, Xu, Xu, Xu, Xu, Xoa, Xoa, Isa, Uu, Urb, Urb, Uu, Uu, Xu, Xu, Xu, Xu, Xu, Xu, Uu, Xu, Cay, Xu, Xu, Xu, Xu, Xu
Xu, Xu, Xu, Xu, Uh, Xu, Uu, Uu^Vud, Uu, Cay, Uu, Uu, Uu, Uh, Uh, Uh, Uh, Xu, Xu, Xu, Uu, Isa, Uu, Ur, Uu, Uu, Xu, Xu, Xu, Xu, Xu, Uh, Uu, Uu, Ur, Ur, Ur, Ur, Ur, Xu, Xu, Xu
Xu, Xu, Uh, Uh, Ur, Uu, Ur, Uu, Ur, Uu, Uu, Uu, Uu, Uu, Uu, Uh, Uh, Xu, Xu, Xu, Uu, Ur, Uu, Uu, Uu, Uu, Xu, Xu, Xu, Xu, Uh, Uu, Ur, Ur, Uu, Uu^Vud, Uu, Ur, Ur, Xu, Xu, Xu
Xu, Uh, Uu, Uu, Ur, Ur, Uu, Uu, Uu, Ur, Ur, Ur, Ur, Ur, Uu, Uu, Uu, Uh, Uu, Cay, Ur, Ur, Uu, Uu, Xu, Xu, Xu, Xu, Uh, Uh, Ur, Ur, Uu, Uu, Cay, Uu, Uu, Uu, Ur, Xu, Xu, Xu
Xu, Uu, Ur, Ur, Uu, Uu, Uu, Uu, Uu, Cay, Uu, Uu, Uu, Uu, Uu, Ur, Ur, Uu, Ur, Ur, Cay, Uu, Uu, Uu, Xu, Xu, Xu, Xu, Uh, Ur, Ur, Uu, Xu, Xu, Xu, Uu, Uu, Uu, Ur, Xu, Xu, Xu
Xu, Xu, Ur, Uu, Uh, Uu, Xu, Xu, Xu, Xu, Xu, Uu, Xu, Uu, Uu, Uu, Uu, Ur, Ur, Uu, Uu, Uu, Xu, Xu, Xu, Xu, Uh, Uh, Uu, Ur, Uu, Uu, Xu, Xu, Xu, Uu, Uu, Tb^Tf, Ur, Xu, Xu, Xu
Xu, Ur, Uu, Uh, Uh, Xu, Xu, Xu, Xu, Xu, Xu, Xu, Xu, Xu, Uu, Uu, Uu, Ur, Uu, Uu, Cay, Xu, Xu, Xu, Xu, Xu, Uh, Uh, Ur, Ur, Uu, Uu, Xu, Xu, Xu, Uu, Uu, Tb^Tf, Ur, Xu, Xu, Xu
Xu, Ur, Uu, Uh, Uh, Xu, Xu, Xu, Xu, Xu, Xu, Xu, Xu, Xu, Uu, Uu, Uu, Ur, Uu, Uu, Xu, Xu, Xu, Xu, Uu, Uu, Uu, Uu, Ur, Uu, Uu, Xu, Xu, Xu, Xu, Uh, Uu, Ur, Uu, Xu, Xu, Xu
Xu, Ur, Uu, Uh, Xu, Xu, Xu, Xu, Xu, Xu, Xu, Xu, Xu, Uu, Xu, Xu, Xu, Uu, Xu, Xu, Xu, Xu, Xoa, Xoa, Uu, Uu, Ur, Ur, Uu, Uu, Uu^Vud, Xu, Xu, Xu, Uh, Uh, Uu, Ur, Uu, Xu, Xu, Xu
Xu, Ur, Uu, Uu, Xoa, Xu, Xu, Xu, Xu, Xu, Xu, Xu, Xu, Xu, Xu, Xu, Xu, Xu, Xu, Xu, Xoa, Xoa, Uu, Uu, Ur, Ur, Uu, Uu, Xu, Xu, Xu, Xu, Xu, Xu, Uh, Uu, Ur, Ur, Uu, Xu, Xu, Xu
Xu, Ur, Ur, Uu, Uu, Xu, Xoa, Xu, Xu, Xu, Xu, Xu, Xu, Xu, Xu, Uu, Xoa, Xu, Xoa, Xu, Uu, Uu, Isa, Isa, Uu, Uu, Xu, Xu, Xu, Xu, Xu, Xu, Xu, Xu, Uh, Uu, Ur, Uu, Uu, Xu, Xu, Xu
Xu, Uu, Ur, Uu, Uu, Uu, Uu, Uu, Uu, Uh, Uh, Uh, Uh, Uh, Uu, Uu, Ur, Cay, Isa, Uu, Isa, Isa, Ur, Uu, Xu, Xu, Xu, Xu, Xu, Xu, Xu, Xu, Uh, Uh, Uu, Ur, Uu, Uu, Xu, Xu, Xu, Xu
Xu, Xu, Xoa, Ur, Isa, Ur, Isa, Isa, Isa, Uu, Uu, Uu, Isa, Isa, Ur, Ur, Uu, Isa, Isa, Isa, Ur, Isa, Ur, Ur, Cay, Cay, Cay, Xu, Uu^Vu, Xu, Uh, Uh, Uu, Uu, Ur, Ur, Xu, Xu, Xu, Xu, Xu, Xu
Xu, Xu, Xoa, Uu^Vud, Xoa, Uu, Uu, Isa, Uu, Ur, Ur, Ur, Uu, Uu, Uu, Uu, Uu, Cay, Uu, Uu, Uu, Uu, Xu, 4 Isa, Cay, 3 Kay, Cay, Xu, Uu, Uu, Uu, Uu, Ur, Ur, Tb^Tf, Tb^Tf, Xu, Xu, Xu, Xu, Xu, Xu
Xu, Xu, Xu, Xu, Xu, Xu, Xu, Uh, Uh, Uu, Uu^Vud, Uu, Uh, Uh, Uu, Uu, Uu, Uu, Uu, Uu, Tb^Tf, Xu, Xu, Xu, Xu, Cay, Uu, Isa, Isa, Isa, Isa, Ur, Tb^Tf, Uu, Xu, Xu, Xu, Xu, Xu, Xu, Xu, Xu
Xu, Xu, Xu, Xu, Xu, Xu, Xu, Xu, Xu, Uh, Xu, Uh, Xu, Xu, Xu, Xu, Xu, Cay, Uu, Uu, Xu, Xu, Xu, Xu, Uu, Uu, Ur, Ur, Uu, Isa, Uu, Uu, Uh, Xu, Xu, Xu, Xu, Xu, Xu, Xu, Xu, Xu
Xu, Xu, Xu, Xu, Xu, Xu, Xu, Xu, Xu, Xu, Xu, Xu, Xu, Xu, Xu, Xu, Xu, Xu, Xu, Uu, Xu, Xu, Xu, Uu, Xoa, Uu, Ur, Uu, Cay, Uu, Uu, Uu, Uh, Xu, Xu, Xu, Xu, Xu, Xu, Xu, Xu, Xu
Xu, Xu, Xu, Xu, Xu, Xu, Xu, Xu, Xu, Xu, Xu, Xu, Xu, Xu, Xu, Xu, Xu, Xu, Xu, Xu, Xu, Xu, Xu, Xu, Xoa, Uu, Isa, Cay, Cay, Cay, Isa, Uh, Uh, Xu, Xu, Xu, Xu, Xu, Xu, Xu, Xu, Xu
Xu, Xu, Xu, Xu, Xu, Xu, Xu, Xu, Xu, Xu, Uh, Xu, Uh, Uh, Uh, Uh, Uu, Xu, Xoa, Xu, Tb^Tf, Xu, Xu, Xu, Uu, Uu, Ur, Cay, Cay, Cay, Uu, Uu, Uh, Uh, Xu, Xu, Xu, Xu, Xu, Xu, Xu, Xu
Qxu, Xu, Xu, Xu, Xu, Xu, Xu, Xu, Xu, Uh, Uu, Uh, Uh, Uh, Uu, Uu, Uu, Uu, Cay, Uu, Uu, Xoa, Xoa, Uu, Uu, Isa, Ur, Ur, Uu, Isa, Uh, Uh, Xu, Xu, Xu, Xu, Xoa, Xu, Xu, Xu, Xu, Xu
Qxu, Xu, Xu, Xu, Xu, Xu, Xoa, Xoa, Uu, Uu, Uu, Uu, Uu, Uu, Ur, Uu, Uu, Uu, Cay, Uu, Uu, Uu, Isa, Uu, Ur, Ur, Isa, Uu, Uu, Uh, Xu, Xu, Xu, Xu, Xu, Xoa, Uu, Uu, Uu^Vu, Xu, Xu, Xu
Qxu, Qxu, Qxu, Xu, Xu, Xu, Uu^Vu, Uu, Uu, Uu, Ur, Ur, Ur, Ur, Isa, Isa, Uu, Uu, Cay, Uu, Uu, Isa, Uu^Vud, Ur, Uu, Uu, Isa, Uu, Uu, Xu, Xu, Xu, Xu, Xu, Uu, Uu, Urb, Urb, Uu, Xu, Xu, Xu
Xu, Qxu, Qxu, Qxu, Qxu, Xu, Uu, Uu, Uu, Uu, Ur, Uu, Uu, Ur, Isa, Isa, Isa, Uu, Cay, Uu, Isa, Ur, Uh, Uh, Xu, Uu, Isa, Uu, Uu, Xu, Xu, Xu, Xoa, Xoa, Urb, Urb, Urb, Urb, Uu, Xu, Xu, Xu
Xu, Xu, Qxu, Qxu, Qxu, Uu, Uu^Es, Uu^Es, Ur, Ur, Uu, Uu, Tb^Tf, Uu, Uu, Isa, Isa, Uu, Cay, Uu, Isa, Isa, Uu, Uh, Xu, Uu, Isa, Isa, Uu, Xoa, Xoa, Xoa, Urb, Urb, Urb, Urb, Urb, Urb, Uu, Xoa, Xu, Xu
Xu, Xu, Xu, Qxu, Uu, Uu, Isa, Isa, Isa, Uu, Uu, Tb^Tf, Uh, Tb^Tf, Uu, Ur, Uu, Ur, Ur, Ur, Uu, Uu, Isa, Xu, Xoa, Uu, Isa, Isa, Isa, Uu, Isa, Rr^Pr\o, Xoa, Isa, Uu, Urb, Urb, Urb, Uu, Xoa, Xu, Xu
Xu, Xu, Uu, Uu, Uu, Uu, Ur, Isa, Isa, Uu, Ds, Ds, Ds, Uh, Uh, Uu, Uu, Uu, Cay, Ur, Isa, Isa, Isa, Xoa^Efs, Isa, Isa, Uu, Isa, Isa, Isa, Isa, Isa, Xoa, Uu, Xoa, Uu, Uu, Urb, Uu, Xoa, Xu, Xu
Xu, Xu, Cay, Uu, Ur, Ur, Isa, Ur, Uu, Uu, Ds, Ds, Ds, Uh, Uh, Uh, Uu, Uu, Cay, Isa, Isa, Isa, Uu, Isa, Isa, Isa, Isa, Ur, Ur, Uu, Xoa, Xu, Xu, Xu, Xu, Xu, Xu, Uu, Uu, Xoa, Xu, Xu
Xu, Xu, Uu, Cay, Cay, Ur, Isa, Isa, Uu^Es, Uu, Uu, Ds, Uu, Uu^Vu, Uu, Ur, Uu, Uu, Cay, Isa, Uu, Uu, Uu, Uu, Uu, Uu, Ur, Ur, Ur, Ur, Rr^Pr/, Xoa, Xoa, Xu, Xu, Xu, Xu, Xu, Xu, Xu, Xu, Xu
Xu, Xu, Tb^Tf, Uu, Uu, Cay, Ur, Ur, Isa, Uu, Uu, Uu, Uu, Uu, Uu, Ur, Xoa, Xoa, Xoa, Uu, Uu, Uu, Uu, Uu, Uu, Uu, Uu, Uu, Xoa, Isa^Pr/o, Isa, Urb, Urb, Xoa, Uu, Xu, Xoa, Xu, Xu, Xu, Xu, Xu
Xu, Xu, Tb^Tf, Tb^Tf, Uu, Uu, Uu, Ur, Ur, Cay, Cay, Cay, Cay, Uu, Ur, Ur, Xoa, Xu, Xu, Xoa, Xoa, Uu, Tb^Tf, Uu, Xoa, Uu^Vu, Xoa, Xoa, Xu, Xoa, Xoa, Isa, Urb, Urb, Urb, Uu, Uu, Xoa, Xoa, Xu, Xu, Xu
Xu, Xu, Xu, Tb^Tf, Tb^Tf, Uu, Uu, Isa, Isa, Uu, Uu^Es, Cay, Uu, Cay, Cay, Uu, Xu, Xu, Xu, Xu, Xu, Xu, Xu, Xu, Xu, Xoa, Xu, Xu, Xu, Xu, Xoa, Uu, Urb, Urb, Urb, Urb, Urb, Uu, Xu, Xu, Xu, Xu
Xu, Xu, Xu, Tb^Tf, Tb, Uu, Uu, Isa, Isa, Uu, Uu^Es, Uu, Uu, Uu, Uu, Xoa, Xu, Xu, Xu, Xu, Xu, Xu, Xu, Xu, Xu, Xu, Xu, Xu, Xu, Xoa, Uu, Uu, Urb, Urb, Urb, Urb, Urb, Uu, Xoa, Xu, Xu, Xu
Xu, Xu, Xu, Tb^Tf, Uh, Uu, Uu, Isa, Ur, Uu, Uu^Es, Uu, Uu^Es, Uu, Uu, Xoa, Xu, Xu, Xu, Xu, Xu, Xu, Xu, Xu, Xu, Xu, Xu, Xu, Xu, Uu, Uu, Uu, Urb, Urb, Urb, Urb, Urb, Uu, Xoa, Xu, Xu, Xu
Xu, Xu, Xu, Xu, Uh, Uu, Uu, Ur, Ur, Rb, Uu^Es, Uu^Es, Uh^Es, Uu^Es, Xu, Xu, Xu, Xu, Xu, Xu, Xu, Xu, Xu, Xu, Xu, Xu, Xu, Xu, Xu, Xoa, Uu, Uu, Uu, Urb, Urb, Urb, Uu, Uu, Xu, Xu, Xu, Xu
Xu, Xu, Xu, Xu, Uh, Uh, Uu, Uu, Uu, Rb, Uu^Es, Uu, Uh, Uh, Xu, Xu, Xu, Xu, Xu, Xu, Xu, Xu, Xu, Xu, Xu, Xu, Xu, Xu, Xu, Xu, Xu, Uu, Xu, Uu, Xu, Uu, Xu, Uu^Vu, Xu, Xu, Xu, Xu
Xu, Xu, Xu, Xu, Xu, Uh, Uh, Uu, Uu, Rb, Rb, Uu, Uu, Uh, Xu, Xu, Xu, Xu, Xu, Xu, Xu, Xu, Xu, Xu, Xu, Xu, Xu, Xu, Xu, Xu, Xu, Xu, Xu, Xu, Xu, Xu, Xu, Xu, Xu, Xu, Xu, Xu
Xu, Xu, Xu, Xu, Xu, Uh, Uh, Uu, Uu, Rb, Rb, Uu, Xoa, Xu, Xoa, Xu, Xu, Xu, Xu, Xu, Xu, Xu, Xu, Xu, Xu, Xu, Xu, Xu, Xu, Xu, Xu, Xu, Xu, Xu, Xu, Xu, Xu, Xu, Xu, Xu, Xu, Xu
Xu, Xu, Xu, Xu, Xu, Xu, Xu, Xu, Uu, Rb, Rb, Uu, Uu, Xoa, Uu, Uu, Ur, Uu^Vu, Xu, Xu, Xu, Xu, Xu, Xu, Xu, Xu, Uu, Xuc, Xuc, Xu, Xu, Xu, Xu, Xu, Xu, Xu, Xu, Xu, Xu, Xu, Xu, Xu
Xu, Xu, Xu, Xu, Xu, Xu, Qxu, Qxu, Uu, Rb, Rb, Uu, Uu, Cay, Uu, Uu, Ur, Uu^Vu, Xu, Xu, Xu, Xu, Xu, Xu, Uu, Uh, Uh, Uh, Uu, Uu, Tb^Tf, Xuc, Xuc, Xu, Xu, Xu, Xu, Xu, Xu, Xu, Xu, Xu
Xu, Xu, Xu, Xu, Xu, Xu, Uh, Qxu, Uu, Uu^Es, Ur, Uu, Urb, Urb, Urb, Urb, Uu, Uu^Vu, Xu, Xu, Xu, Xu, Xuc, Xuc, Uu, Uu, Uu, Uu, Uu, Uu, Uu, Tb^Tf, Tb^Tf, Xuc, Xu, Xu, Xu, Xu, Xu, Xu, Xu, Xu
Xu, Xu, Xu, Xu, Xu, Uh, Uh, Uh, Uu, Uu^Es, Ur, Ur, Uu, Uu, Uu, Uu, Uu, Uu, Xu, Xu, Xu, Xu, Uu, Uu, Uu, Uu, Uu, Co, 2 Ko, Co, Uu, Uu, Tb^Tf, Tb^Tf, Tb^Tf, Xu, Xu, Xu, Xu, Xu, Xu, Xu
Xu, Xu, Xu, Xu, Xu, Uh, Uh, Uu, Uu, Urb, Uu, Uu, Uu, Cay, Xoa, Uu, Xu, Xu, Xu, Xu, Xu, Xuc, Uu, Uu, Uu, Uu, Uu, Co, Co, Co, Uu, Uu, Tb^Tf, Tb^Tf, Uu, Tb^Tf, Xuc, Xu, Xuc, Xu, Xu, Xu
Xu, Xu, Xu, Xu, Xu, Uh, Uu, Uu, Uu, Urb^Es, Uu^Es, Uu, Uu, Uu, Uu, Xoa, Xu, Xu, Xu, Xu, Tb^Tf, Uu, Uu, Uu, Uu, Uu, Uu, Rb, Co, Rb, Uu, Uu, Uu, Uu, Uu, Uu, Uu, Xuc, Re, Re, Re, Xu
Xu, Xu, Xu, Xu, Xu, Uu^Vu, Uu, Uu, Uu, Urb, Uu, Uu^Es, Uu, Uu, Xu, Xu, Xu, Xu, Tb^Tf, Tb^Tf, Tb^Tf, Tb^Tf, Uu, Uu^Es, Uu^Es, Uu, Re, Rb, Rb, Rb, Rb, Rb, Rb, Re, Rb, Re, Re, Re, Re, Re, Re, Re
Xu, Xu, Xu, Xu, Xu, Xu, Cay, Cay, Cay, Urb, Cay, Cay, Cay, Xu, Xu, Xu, Xuc, Uu, Uu, Tb^Tf, Uu, Uu, Uu, Uu, Rb, Rb, Rb, Rb, Rb, Rb, Re, Re, Uu, Rb, Uu, Re, Uu, Re, Uu, Re, Re, Re
Xu, Xu, Xu, Xu, Xu, Xu, Uu, Uu, Urb, Urb, Uu, Uu, Xu, Xu, Xu, Xu, Uu, Uu, Uu, Uu, Uu, Uu, Uu, Uu, Rb, Rb, Re, Rb, Uh, Uh, Uu, Uu, Uu, Uu, Xu, Uu, Xu, Uu, Uu, Uu, Uu, Xu
Xu, Xu, Xu, Xu, Xu, Uu, Uu, Uu, Urb, Uu, Uu, Uu, Xu, Xu, Xu, Xu, Uu, Uu, Re, Re, Rb, Rb, Rb, Rb, Re, Re, Uu, Uu, Uh, Uh, Tb^Tf, Tb^Tf, Xu, Xu, Xu, Xu, Xu, Xu, Xu, Xu, Xu, Xu
Xu, Xu, Xu, Xu, Xu, Uu, Uu, Uu, Urb, Uu, Uu, Uu, Xu, Xu, Xu, Xu, Uu, Uu, Uu, Rb, Rb, Rb, Uu, Uu, Uu, Uu, Uu, Uu, Uu, Tb^Tf, Xu, Xu, Xu, Xu, Xu, Xu, Xu, Xu, Xu, Xu, Xu, Xu
Xu, Xu, Xu, Xu, Xu, Uu, Uu, Uu, Ur, Uu, Uu, Uu, Uu^Vu, Xu, Uu, Uu, Ur, Uu, Urb, Urb, Urb, Uu, Urb, Uu, Uu, Uu, Tb^Tf, Uu, Uu, Tb^Tf, Xuc, Xu, Xu, Xu, Xu, Xu, Xu, Xu, Xu, Xu, Xu, Xu
Xu, Xu, Xu, Xu, Xu, Uu, Uu, Uu, Urb, Urb, Ur, Uu, Ur, Uh, Urb, Ur, Ur, Ur, Uu, Urb, Urb, Urb, Urb, Urb, Urb, Urb, Urb, Uu, Uu, Uu, Tb^Tf, Xuc, Uu, Xuc, Xuc, Xu, Xu, Xu, Xu, Xu, Xu, Xu
Xu, Xu, Xu, Xu, Xu, Uu, Tb^Tf, Uu, Uu, Urb, Uu, Ur, Uu, Urb, Uu, Uu, Xu, Uu, Uu, Uu, Uu, Uu, Uu, Urb, Uu, Urb, Urb, Urb, Ur, Uu, Uu, Uu, Uu, Uu, Ur, Uu^Vu, Xuc, Xu, Xu, Xu, Xu, Xu
Xu, Xu, Xu, Xu, Xu, Xu, Tb^Tf, Uu, Uu, Uu, Uu, Uu, Xu, Uu, Xu, Xu, Xu, Xu, Xu, Uu, Xu, Uu, Xu, Uu, Uu, Uu, Uu, Ur, Ur, Tb^Tf, Uu, Tb^Tf, Uu, Uu, Uu, Uu, Uu, Xu, Xu, Xu, Xu, Xu
Xu, Xu, Xu, Xu, Xu, Xu, Xu, Tb^Tf, Tb^Tf, Uu, Xu, Xu, Xu, Xu, Xu, Xu, Xu, Xu, Xu, Xu, Xu, Xu, Xu, Xu, Xu, Uu, Uu, Uu, Uu, Ur, Ur, Uu, Uu, Uu, Uu, Uh, Ur, Uu^Vu, Xu, Xu, Xu, Xu
Xu, Xu, Xu, Xu, Xu, Xu, Xu, Xu, Xu, Tb^Tf, Xu, Xu, Xu, Xu, Xu, Xu, Xu, Xu, Xu, Xu, Xu, Xu, Xu, Xu, Xu, Xu, Xu, Uu, Uu, Ur, Ur^Es, Urb, Uu, Tb^Tf, Ur, Ur, Uu^Vu, Xu, Xu, Xu, Xu, Xu
Xu, Xu, Xu, Xu, Xu, Xu, Xu, Xu, Xu, Xu, Xu, Xu, Xu, Xu, Xu, Xu, Xu, Xu, Xu, Xu, Xu, Xu, Xu, Xu, Xu, Xu, Xu, Uu, Uu^Es, Uu^Es, Ur^Es, Ur, Uu, Tb^Tf, Uu, Uu, Xu, Xu, Xu, Xu, Xu, Xu
Xu, Xu, Xu, Xu, Xu, Xu, Xu, Xu, Xu, Xu, Xu, Xu, Xu, Xu, Xu, Xu, Xu, Xu, Xu, Wog, Wog, Xu, Xu, Xu, Xu, Xu, Xu, Uu, Tb^Tf, Uu, Urb, Ur, Uu, Tb^Tf, Uu, Uu, Xu, Xu, Xu, Xu, Xu, Xu
Xu, Xu, Xu, Xu, Xu, Xu, Xu, Xu, Xu, Xu, Xu, Xu, Xu, Xu, Xu, Xu, Xu, Xu, Xu, Wog, Wog, Wog, Wog, Xu, Xu, Xu, Xu, Uu, Tb^Tf, Tb^Tf, Ur, Ur, Uu, Uu, Uu, Uu, Xuc, Xu, Xu, Xu, Xu, Xu
Xu, Xu, Xu, Xu, Xu, Xu, Xu, Xu, Xu, Xu, Uu, Xu, Xu, Xu, Xu, Xu, Xu, Xu, Xu, Xu, Xu, Wog, Wog, Xu, Xu, Xu, Xu, Uu, Uu, Tb^Tf, Uu, Ur, Urb, Uu, Uu, Uu, Tb^Tf, Xuc, Xu, Xu, Xu, Xu
Xu, Xu, Xu, Xu, Xu, Xu, Xu, Xu, Xuc, Uu, Uu^Ecf, Uu, Xu, Xu, Xu, Xu, Xu, Xu, Xu, Xu, Xu, Xu, Xu, Wog, Wog, Xu, Xu, Uu, Uu, Tb^Tf, Uu, Urb, Urb, Uu, Uu, Uh, Tb^Tf, Tb^Tf, Uh, Xu, Xu, Xu
Xu, Xu, Xuc, Xuc, Uh, Xu, Uh, Xuc, Uh, Uu, Uu^Edt, Uu, Xu, Xu, Uh, Xuc, Uh, Xuc, Uu, Xuc, Xuc, Xu, Xu, Xu, Xu, Wog, Xu, Uu^Vu, Ur, Uu, Uu, Urb, Urb, Uu, Uu, Uh, Uh, Tb^Tf, Uh, Xu, Xu, Xu
Xu, Xu, Uh, Uh, Uh, Uh, Tb^Tf, Uh, Uu, Uh^Edt, Uu^Edt, Xu, Xu, Uh, Uu, Uh, Uu, Uh, Uu, Uu, Ur, Uu^Vu, Uu, Xu, Xu, Wog, Wog, Xu, Uu, Ur, Uu, Ce, Urb, Urb, Uu, Ce, Uh, Tb^Tf, Uh, Xu, Xu, Xu
Xu, Uh, Uh, Uh, Uh, Tb^Tf, Tb^Tf, Uu, Uu, Uu, Uu, Xuc, Xuc, Uu, Uu, Uu, Uu, Uu, Uu, Uu, Uu, Ur, Uu, Uu, Tb^Tf, Xu, Wog, Xu, Uu, Uh, Uh, Uu, Uu, Urb, Ur, Uu, Uh, Tb^Tf, Uh, Xu, Xu, Xu
Xu, Uu, Uu, Uu, Uu, Uu, Uu, Uu, Uu, Ce, Uu, Uu, Uu, Uu, Uu, Uu, Uu, Tb^Tf, Tb^Tf, Tb^Tf, Tb^Tf, Ur, Uu, Tb^Tf, Tb^Tf, Xuc, Wwg, Xuc, Uu, Uh, Uh, Uh, Uu, Ur, Ur, Uu, Uh, Uh, Uh, Xu, Xu, Xu
Xu, Uu, Uu^Es, Uu^Es, Uu^Vud, Uu, Uu, Uu, Rb, Uu, Ur, Ur, Rb, Ce, Rb, Uu, Uu, Uu, Uu^Es, Uu, Uu, Uu, Uu, Tb^Tf, Tb^Tf, Tb^Tf, Wwg, Wwg, Uh, Uh, Uh, Uu, Urb, Urb, Urb, Uu, Uh, Uh, Tb^Tf, Xu, Xu, Xu
Xu, Uu, Uu, Uu^Vud, Rb, Uu, Rb, Rb, Xu, Rb, Uu, Ur, Uu, Rb, Rb, Rb, Rb, Rb, Ur, Uu^Es, Ur, Uu, Uu, Uu, Uu, Uu, Wwg, Wwg, Uu, Uh, Uu, Uu, Ur, Urb, Uu, Uu, Uu, Uh, Tb^Tf, Xu, Xu, Xu
Xu, Uu, Ur, Rb, Rb^Es, Uu^Es, Rb, Rb, Xu, Uu, Tb^Tf, Uu, Uh, Uu, Uh, Rb, Rb, Rb^Es, Ur, Ur, Ur, Ur, Urb, Urb, Urb, Wwg, Wwg, Wwg, Urb, Uu, Urb, Ur, Ur, Ur, Uu^Es, Ur, Ur, Uu, Uu, Xu, Xu, Xu
Xu, Uu^Vu, Ur, Rb, Rb^Es, Rb, Xu, Xu, Xu, Tb^Tf, Uh, Uh, Uh, Uh, Uh, Ce, Uu, Ur, Ur, Rb, Ur, Urb, Urb, Urb, Wwg, Wwg, Wwg, Wwg, Wwg, Urb, Uh, Urb, Uh, Uu^Es, Uu, Ur, Uu, Uu, Uu^Vu, Xu, Xu, Xu
Xu, Uu^Vu, Uu, Ur, Ur, Ur, Xu, Xu, Xu, Uh, Uh, Uh, Tb^Tf, Uh, Uh, Uh, Uu, Ur, Ur, Uu, Uu, Urb^Dr, Uu, Uu, Wwg, Wwg, Wwg, Wwg, Wwg, Uh, Uh, Uh, Tb^Tf, Tb^Tf, Tb^Tf, Uh, Uh, Uu, Xu, Xu, Xu, Xu
Xuc, Uu, Uu, Urb, Urb, Ur, Xuc, Xu, Xuc, Uu, Uh, Tb^Tf, Tb^Tf, Uh, Uh, Uu, Uu, Uu, Tb^Tf, Tb^Tf, Tb^Tf, Uu, Wwg, Wwg, Wwg, Wog, Wog, Wog, Wwg, Wwg, Uu, Uu, Uu, Tb^Tf, Uh, Uh, Xu, Xu, Xu, Xu, Xu, Xu
Xuc, Uu, Uu^Es, Uu^Dr, Ur, Ur, Ur, Ur, Ur, Uu, Uh, Tb^Tf, Tb^Tf, Uu, Ur, Ur, Xu, Uu, Tb^Tf, Tb^Tf, Tb^Tf, Tb^Tf, Wwg, Wwg, Wwg, Wog, Wog, Wog, Wwg, Wwg, Wwg, Uu, Uu, Uh, Uh, Uh, Xu, Xu, Xu, Xu, Xu, Xu
Xuc, Uu, Uu, Uu^Es, Uu, Ur, Urb, Ur, Uu, Uu, Uu, Uh, Uu, Tb^Tf, Ur, Xu, Xu, Uu, Uu, Uu, Uu, Tb^Tf, Wwg, Wwg, Wwg, Wog, Wog, Wog, Wog, Wwg, Wwg, Wwg, Wwg, Uu, Xu, Xu, Xu, Xu, Xu, Xu, Xu, Xu
Xu, Uu, Uu, Uu^Es, Uu, Urb, Urb, Uu, Uu^Dr, Uu, Uu, Uu, Uu, Uu, Ur, Xu, Xu, Xu, Xu, Uu, Uu, Uu, Wwg, Wwg, Wwg, Wwg, Wog, Wog, Wog, Wog, Wwg, Wwg, Uu, Uu, Xu, Xu, Xu, Xu, Xu, Xu, Xu, Xu
Xu, Uu, Uu, Uu, Uu, Urb, Urb, Uu, Uu, Ur, Uu, Uu, Ur, Ur, Xu, Xu, Xu, Xu, Xu, Xu, Xu, Uu, Uu, Wwg, Wwg, Wwg, Wwg, Wog, Wog, Wwg, Wwg, Wwg, Uu^Vu, Xu, Xu, Xu, Xu, Xu, Xu, Xu, Xu, Xu
Xu, Xu, Xu, Uu, Uu, Uu, Uu, Urb, Urb, Uu, Ur, Ur, Ur, Ur, Xu, Xu, Xu, Xu, Xu, Xu, Xu, Uu, Uu, Uu, Uu, Wwg, Wwg, Wog, Wog, Wwg, Uu, Uu, Xu, Xu, Xu, Xu, Xu, Xu, Xu, Xu, Xu, Xu
Xu, Xu, Xu, Xu, Uu, Uu, Uu, Urb, Urb, Urb, Urb, Uu^Dr, Uu, 1 Uu, Xu, Xu, Xu, Xu, Xu, Xu, Xu, Uu^Vu, Xu, Uu, Wwg, Wwg, Wog, Wog, Wog, Wwg, Xu, Xu, Xu, Xu, Xu, Xu, Xu, Xu, Xu, Xu, Xu, Xu
Xu, Xu, Xu, Xu, Xu, Xu, Xu, Uu, Uu, Urb, Urb, Urb, Uu, Uu, Uu, Xu, Xu, Xu, Xu, Xu, Xu, Xu, Xu, Xu, Xu, Xu, Xu, Xu, Xu, Xu, Xu, Xu, Xu, Xu, Xu, Xu, Xu, Xu, Xu, Xu, Xu, Xu
Xu, Xu, Xu, Xu, Xu, Xu, Xu, Uu, Uu, Uu, Uu, Urb, Urb, Uu, Uu, Uu, Uu, Uu, Uu, Xu, Xu, Xu, Xu, Xu, Xu, Xu, Xu, Xu, Xu, Xu, Xu, Xu, Xu, Xu, Xu, Xu, Xu, Xu, Xu, Xu, Xu, Xu
