Ms, Ms, Ms, Ms, Ms, Ms, Ms, Ms, Ms, Ms^Xm, Ms^Xm, Ms^Xm, Ms^Xm, Ms^Xm, Ms^Xm, Xu, Xu, Xu, Re, Re, Ur, Ur, Ur, Xu, Xu, Ms^Xm, Ms^Xm, Ms^Xm, Ms^Xm, Ms^Xm, Ms^Xm, Ms^Xm, Ms, Ms, Ms, Ms, Ms, Ha^Fpa, Ha^Fpa, Ha^Fpa, Ha^Fpa, Ha
Ms, Ms, Ms, Ms, Ms, Ms, Ms, Ms, Ms, Ms^Xm, Ms^Xm, Ms^Xm, Ms^Xm, Ms^Xm, Ms^Xm, Xu, Xu, Xu, Re, Re, Re, Ur, Xu, Xu, Xu, Ms^Xm, Ms^Xm, Ms^Xm, Ms^Xm, Ms^Xm, Ms^Xm, Ms^Xm, Ms, Ms, Ms, Ms, Ms, Ha, Ha, Ha^Fpa, Ha, Ha
Ms, Ms, Ms, Ms, Ms, Ms, Ms, Ms, Ms, Ms, Ms^Xm, Ms^Xm, Ms^Xm, Ms^Xm, Ms^Xm, Ms^Xm, Ms^Xm, Xu, Xu, Ur, Ur, Re, Xu, Xu, Ms^Xm, Ms^Xm, Ms^Xm, Ms^Xm, Ms^Xm, Ms^Xm, Ms^Xm, Ms^Xm, Ms, Ms, Ms, Ms, Ms, Ms, Coa, Ha, 5 Koa, Ha
Ms, Ms, Ms, Ms, Ms, Ms, Ms, Ms, Ms, Ms, Ms^Xm, Ms^Xm, Ms^Xm, Ms^Xm, Ms^Xm, Ms^Xm, Ms^Xm, Xu, Xu, Xu, Uu, Ur, Xu, Xu, Ms^Xm, Ms^Xm, Ms^Xm, Ms^Xm, Ms^Xm, Ms^Xm, Ms^Xm, Ms^Xm, Ms, Ms, Ms, Ms, Ms, Ms, Coa, Coa, Coa, Ha
Ms, Ms, Ms, Ms, Ms, Ms, Ms, Ms, Ms, Ms, Ms, Ms^Xm, Ms^Xm, Ms^Xm, Ms^Xm, Ms^Xm, Ms^Xm, Xu, Xu, Qxu, Qxu, Ur, Ur, Xu, Xu, Ms^Xm, Ms^Xm, Ms^Xm, Ms^Xm, Ms^Xm, Ms^Xm, Ms^Xm, Ms, Ms, Ms, Ms, Ms, Ms, Ha, Coa, Coa, Ha
Ms, Ms, Ms, Ms, Ms, Ms, Ms, Ms, Ms, Ms, Ms, Ms^Xm, Ms^Xm, Ms^Xm, Ms^Xm, Ms^Xm, Ms^Xm, Ms^Xm, Xu, Uu, Uu, Uu, Ur, Xu, Xu, Ms^Xm, Ms^Xm, Ms^Xm, Ms^Xm, Ms^Xm, Ms^Xm, Ms, Ms, Ms, Ms, Ms, Ms, Ha, Ha, Rb, Ha, Ha
Ms, Ms, Ms, Ms, Ms, Ms, Ms, Ms, Ms, Ms, Ms, Ms, Ms^Xm, Ms^Xm, Ms^Xm, Ms^Xm, Ms^Xm, Xu, Xu, Uu, 2 Uu, Uu, Uu, Xu, Xu, Ms^Xm, Ms^Xm, Ms^Xm, Ms^Xm, Ms^Xm, Ms^Xm, Ms, Ms, Ms, Ms, Ms, Ms, Ha, Ha^Fpa, Rb, Ha, Ha
Ms, Ms, Ms, Ms, Ms, Ms, Ms, Ms, Ms, Ms, Ms, Ms, Ms^Xm, Ms^Xm, Ms^Xm, Ms^Xm, Ms^Xm, Xu, Xu, Uu, Ur, Uu, Uu, Xu, Xu, Ms^Xm, Ms^Xm, Ms^Xm, Ms^Xm, Ms^Xm, Ms, Ms, Ms, Ms, Ms, Ms, Ha, Ha, Rb, Rb, Ha^Fpa, Ha^Fpa
Ms, Ms, Ms, Ms, Ms, Ms, Ms, Ms, Ms, Ms, Ms, Ms, Ms^Xm, Ms^Xm, Ms^Xm, Ms^Xm, Ms^Xm, Xu, Xu, Uu, Ur, Ur, Uu, Xu, Xu, Ms^Xm, Ms^Xm, Ms^Xm, Ms^Xm, Ms^Xm, Ms, Ms, Ms, Ms, Ms, Ms, Ha^Fpa, Aa^Fpa, Aa, Ha, Ha, Ha^Fpa
Ms, Ms, Ms, Ms, Ms, Ms, Ms, Ms, Ms, Ms, Ms, Ms, Ms^Xm, Ms^Xm, Ms^Xm, Ms^Xm, Ms^Xm, Xu, Xu, Re, Ur, Re, Xuc, Xu, Xu, Ms^Xm, Ms^Xm, Ms^Xm, Ms^Xm, Ms^Xm, Ms, Ms, Ms, Ms, Ms, Ms, Ha^Fpa, Ha^Fpa, Rb, Ha, Ha, Ha
Mm, Ms, Mm, Ms, Ms, Ms, Ms, Ms, Ms, Ms, Mm^Xm, Mm^Xm, Mm^Xm, Mm^Xm, Mm^Xm, Mm^Xm, Mm^Xm, Xu, Xu, Re, Ur, Ur, Ur, Xu, Xu, Xu, Mm^Xm, Mm^Xm, Mm^Xm, Mm, Ms, Ms, Ms, Ms, Ms, Ha^Fpa, Ha^Fpa, Rb, Ha, Ha, Ms, Ms
Mm, Mm, Mm, Ms, Ms, Ms, Ms, Ms, Ms, Mm^Xm, Mm^Xm, Mm^Xm, Mm^Xm, Mm^Xm, Mm^Xm, Mm^Xm, Xu, Xu, Ur, Rp, Ce, Rp, Rp, Uu^Vud, Xu, Xu, Mm^Xm, Mm^Xm, Mm^Xm, Mm, Ms, Ms, Ms, Ms, Ms, Ha^Fpa, Aa^Fpa, Rb, Ha, Ha, Ms, Ms
Ms, Mm, Mm, Ms, Ms, Ms, Ms, Ms, Ms, Mm^Xm, Mm, Mm^Xm, Mm^Xm, Mm^Xm, Mm, Mm^Xm, Ms, Xu, Uu, Ur, Uu, Rp, Uu, Uu, Xu, Xu, Mm^Xm, Mm^Xm, Mm^Xm, Mm^Xm, Mm, Ms, Ms, Ms, Mm, Ha, Ha, Aa, Ha, Ms, Ms, Ms
Ms, Mm, Mm, Mm, Ms, Ms, Ms, Ms, Ms, Mm, Mm, Mm^Xm, Mm^Xm, Mm^Xm, Mm, Mm, Ms, Xu, Xu, Uu, Uu, Rp, Uu, Uu, Xu, Xu, Mm, Mm^Xm, Mm^Xm, Mm^Xm, Mm^Xm, Mm, Mm, Mm, Ms, Ha, Rb, Rb, Ha, Ms, Ms, Ms
Ms, Ms, Mm, Mm, Mm, Ms, Ms, Ms, Mm, Mm, Mm, Mm^Xm, Ms^Xm, Mm^Xm, Mm^Xm, Mm, Ms, Ms, Ms, Xuc, Re, Re, Rp, Uu, Xuc, Xu, Mm, Mm^Xm, Mm^Xm, Mm^Xm, Mm^Xm, Mm^Xm, Mm, Ms, Ha^Fpa, Ha, Rb, Ha^Fpa, Ha, Ms, Ms, Ms
Ms, Ms, Ms, Mm, Mm, Mm, Mm, Mm, Ms, Ms, Ms, Ms^Xm, Ms^Xm, Ms^Xm, Ms^Xm, Ms^Xm, Ha, Ms, Ms, Ms, Rp, Re, Rp, Re^Es, Re, Mm, Ms, Mm, Ms^Xm, Ms^Xm, Ms^Xm, Mm^Xm, Ha, Ha, Ha^Fpa, Ha^Fpa, Aa, Ha, Ms, Ms, Ms, Ms
Ha, Ha, Ms, Ms, Ms, Mm, Ms, Ms, Ha, Ha, Ha, Ha, Aa, Ms^Xm, Aa, Ha, Ha, Ms, Ms, Ms, Rp, Co, Rp, Re, Re, Mm, Aa^Fpa, Ms, Ms, Ms^Xm, Mm^Xm, Ms^Xm, Ha, Ha^Fpa, Ha^Fpa, Rb, Ha^Fpa, Ha, Ms, Ms, Ms, Ms
Ha^Fpa, Ha, Ha, Ms, Ha, Ha, Ha, Ms, Ha^Fpa, Ha, Ha, Ha^Vca, Aa, Aa, Aa, Aa, Aa, Ha, Ha, Coa, Coa, 3 Ko, Co, Co, Re, Aa^Fpa, Aa^Fpa, Aa^Fpa, Aa^Fpa, Ms, Ms, Mm, Ha, Aa^Fpa, Ha^Fpa, Aa, Ha, Ha, Ms, Ms, Ms, Ms
Ha^Fpa, Ha^Fpa, Ha, Ha, Ha^Fpa, Ha, Ha, Ha^Fpa, Ha, Aa^Fpa, Aa^Fpa, Aa, Aa, Aa, Aa^Fpa, Aa, Aa, Aa, Aa^Voa, Ha, Aa, Coa, Rp, Re, Re, Aa^Fpa, Aa^Fpa, Aa^Fpa, Aa^Fpa, Aa^Fpa, Aa^Fpa, Aa^Fpa, Aa^Fpa, Ha, Ha, Rb, Ha^Fpa, Ha, Ha, Ms, Ms, Ms
Ha, Ha, Ha, Ha, Ha, Ha, Ha, Ha, Ha, Ha, Aa, Aa, Aa, Aa^Fpa, Aa^Fpa, Aa^Fpa, Aa, Aa, Aa, Aa, Aa, Aa, Rp, Re^Es, Re, Aa^Fpa, Aa^Fpa, Aa^Fpa, Aa^Fpa, Aa^Fpa, Aa^Fpa, Aa^Fpa, Aa^Fpa, Aa^Fpa, Ha, Ha^Fpa, Ha^Fpa, Ha^Fpa, Ha, Ha, Ha, Ms
Ha, Ha, Ha^Fpa, Ha, Aa^Fpa, Aa^Fpa, Aa^Fpa, Aa^Fpa, Aa^Fpa, Aa, Aa, Aa, Aa, Aa^Fpa, Aa^Fpa, Aa^Fpa, Aa, Aa, Aa, Aa, Ha, Aa^Fpa, Aa, Re, Re, Aa, Aa, Aa^Fpa, Aa^Fpa, Aa^Fpa, Aa^Fpa, Aa^Fpa, Aa^Fpa, Aa^Fpa, Aa^Fpa, Rb, Ha, Ha, Ha, Ha, Ms, Ha
Ha^Fpa, Ha^Fpa, Ha^Fpa, Aa^Fpa, Aa^Fpa, Aa^Fpa, Aa^Fpa, Aa^Fpa, Aa^Fpa, Aa^Fpa, Aa, Aa, Aa, Aa, Aa, Aa, Aa^Fpa, Aa, Cea, Aa^Fpa, Ha, Ha, Aa, Re, Re, Aa, Aa^Esa, Aa, Aa, Aa^Fpa, Aa^Fpa, Aa^Fpa, Aa^Fpa, Aa^Fpa, Aa^Fpa, Aa^Fpa, Ha, Ha, Ha, Ms, Ha, Ha
Ha^Fpa, Ha^Fpa, Ha^Fpa, Aa^Fpa, Aa^Fpa, Aa^Fpa, Aa^Fpa, Aa^Fpa, Aa^Fpa, Aa^Fpa, Aa^Fpa, Aa, Aa, Aa, Aa, Aa^Fpa, Re^Vct, Aa, Ce, 1 Kea, Aa^Fpa, Ha, Aa, Re, Re, Aa, Aa, Aa^Fpa, Aa, Aa, Aa, Aa^Fpa, Aa^Fpa, Rb, Aa^Fpa, Aa^Fpa, Aa^Vca, Ha, Ha, Ha, Ha^Fpa, Ha^Fpa
Ha, Ha^Fpa, Ha, Aa^Fpa, Aa^Fpa, Aa^Fpa, Aa^Fpa, Aa^Fpa, Aa^Fpa, Aa^Fpa, Aa^Fpa, Aa^Fpa, Aa^Fpa, Aa, Aa, Aa^Fpa, Aa, Re, Aa^Fpa, Cea, Ce, Aa, Rp, Re, Re, Aa, Ha, Ha, Rb, Aa, Rb, Rb, Aa^Fpa, Aa^Fpa, Aa, Aa, Ai, Aa, Ha, Ha, Ha^Fpa, Ha^Fpa
Ha, Ha, Ha, Ha, Ha, Aa^Fpa, Aa^Fpa, Aa^Fpa, Aa^Fpa, Aa^Fpa, Aa^Fpa, Aa^Fpa, Aa^Fpa, Aa, Aa, Aa, Aa, Aa, Aa, Re, Re, Rp, Re, Re^Es, Rb, Rb, Ha, Ha, Aa^Fpa, Rb, Aa, Aa, Aa, Aa, Aa^Fpa, Ai, Ww, Ai, Ai, Ha, Ha, Ha^Fpa
Ha, Ha, Ha^Fpa, Ha, Ha, Aa, Aa, Aa^Vca, Aa, Aa^Fpa, Aa^Fpa, Aa^Fpa, Aa, Aa, Aa^Esa, Aa, Aa, Aa, Aa, Rp, Re, Re, Re^Esa, Re, Aa, Aa, Aa^Fpa, Aa^Fpa, Aa^Fpa, Aa, Aa, Aa, Aa, Aa, Aa, Ai, Ai, Ww, Ai, Ha, Ha, Ha^Fpa
Ha, Ha, Ha, Ha, Ha, Ha, Aa, Aa, Aa, Aa, Aa, Aa, Aa, Aa, Aa, Aa, Aa, Aa^Fpa, Re, Re^Es, Re, Re, Aa, Aa, Aa, Aa^Fpa, Aa^Fpa, Aa^Fpa, Aa, Aa, Ha, Ha, Ha, Ha, Aa, Aa, Aa, Ai, Aa, Aa, Aa^Fpa, Ha^Fpa
Ha, Ha, Ha, Ha, Ha, Ha, Aa, Aa, Aa^Fpa, Aa, Aa, Aa, Aa, Aa, Aa, Aa, Re, Re, Re, Re, Aa, Aa, Aa^Fpa, Aa, Aa, Aa, Aa, Aa, Aa, Aa, Aa^Fpa, Ha^Fpa, Aa^Fpa, Aa^Fpa, Aa^Fpa, Aa, Aa^Fpa, Aa, Aa^Fpa, Aa, Aa, Aa
Ha, Ha, Ha, Ha^Vhha, Aa, Aa, Aa, Aa, Aa, Aa, Aa, Aa, Coa, Coa, Co, Rp, Re, Re^Esa, Re, Rp, Aa, Aa^Fpa, Aa^Fpa, Ha^Fpa, Aa, Aa, Aa^Fpa, Aa, Aa^Fpa, Aa^Fpa, Aa^Fpa, Aa^Fpa, Aa^Fpa, Aa^Fpa, Aa^Fpa, Aa^Fpa, Aa^Fpa, Aa^Fpa, Aa^Fpa, Aa^Fpa, Aa^Fpa, Aa
Ha^Fpa, Ha, Ha, Aa, Aa, Aa, Aa, Aa, Aa, Aa^Esa, Aa, Aa^Edt, Coa, 4 Koa, Co, Re^Edt, Re, Re, Rra, Aa, Aa^Fpa, Aa, Aa, Aa, Aa, Aa, Aa, Aa, Aa^Fpa, Aa^Fpa, Aa^Fpa, Aa^Fpa, Aa^Fpa, Aa^Fpa, Aa^Fpa, Aa^Fpa, Aa^Fpa, Aa^Fpa, Aa^Fpa, Aa^Fpa, Aa^Fpa, Aa^Fpa
Ha^Fpa, Ha^Fpa, Ha, Aa, Aa^Fpa, Aa^Fpa, Aa^Fpa, Aa, Aa, Aa, Aa, Aa, Aa^Edt, Coa, Aa, Rp, Re, Re, Aa, Aa^Fpa, Aa^Fpa, Aa, Ha, Ha^Vhha, Ha, Aa, Aa, Aa, Aa^Fpa, Aa^Fpa, Aa^Fpa, Aa^Fpa, Aa^Fpa, Aa^Fpa, Aa^Fpa, Aa^Fpa, Aa^Fpa, Aa^Fpa, Aa^Fpa, Aa^Fpa, Aa^Fpa, Aa^Fpa
Ha^Fpa, Ha^Fpa, Aa^Fpa, Aa^Fpa, Aa^Fpa, Aa^Fpa, Aa^Fpa, Aa^Fpa, Aa^Fpa, Aa, Aa, Aa, Aa, Aa, Aa, Aa, Re, Re, Aa, Aa^Fpa, Ha, Ha^Fpa, Ha, Ha, Ha, Ha, Ha, Aa, Aa, Aa^Fpa, Aa, Aa^Fpa, Aa, Aa^Fpa, Aa^Fpa, Aa^Fpa, Aa^Fpa, Aa^Fpa, Aa^Fpa, Aa^Fpa, Ha, Aa^Fpa
Ha^Fpa, Ha^Fpa, Aa^Fpa, Aa^Fpa, Aa^Fpa, Aa^Fpa, Aa^Fpa, Aa^Fpa, Aa^Fpa, Aa^Fpa, Aa^Fpa, Aa, Aa, Aa, Aa^Esa, Aa, Re, Re, Ha, Aa, Ha, Ha, Aa^Fpa, Aa^Fpa, Aa^Fpa, Aa^Fpa, Ha^Fpa, Ha, Ha, Aa, Ha, Aa, Aa, Aa, Aa, Aa^Fpa, Aa^Fpa, Aa^Fpa, Aa^Fpa, Ha, Ha, Ha
Ha^Fpa, Ha^Fpa, Aa^Fpa, Aa^Fpa, Aa^Fpa, Aa^Fpa, Aa^Fpa, Aa^Fpa, Aa^Fpa, Aa^Fpa, Aa^Fpa, Aa^Fpa, Aa^Fpa, Aa, Aa, Re, Rb, Aa, Aa^Fpa, Aa, Aa, Aa^Fpa, Aa^Fpa, Aa^Fpa, Aa^Fpa, Aa^Fpa, Ha^Fpa, Ha^Fpa, Ha, Ha, Ms, Ha, Aa, Aa, Aa, Aa^Vca, Aa^Fpa, Aa^Fpa, Aa^Fpa, Ha, Ha, Ha
Aa^Fpa, Aa^Fpa, Aa^Fpa, Aa^Fpa, Aa^Fpa, Aa^Fpa, Aa^Fpa, Aa^Fpa, Aa^Fpa, Aa^Fpa, Aa^Fpa, Aa^Fpa, Aa^Fpa, Aa^Fpa, Aa, Re, Rb, Rb, Rb, Aa, Aa^Fpa, Aa^Fpa, Aa^Fpa, Aa^Fpa, Aa^Fpa, Aa^Fpa, Ha, Ha, Ha, Ha, Ha^Fpa, Ha^Fpa, Aa^Fpa, Aa, Aa, Aa, Aa^Fpa, Aa^Fpa, Aa^Fpa, Ha^Fpa, Ha^Fpa, Ha
Aa^Fpa, Aa^Fpa, Aa^Fpa, Aa^Fpa, Aa^Fpa, Aa^Fpa, Aa^Fpa, Aa^Fpa, Aa^Fpa, Aa^Fpa, Aa^Fpa, Aa^Fpa, Aa^Fpa, Aa^Fpa, Aa, Aa^Fpa, Rb, Rb^Es, Rb, Aa, Aa, Aa^Fpa, Aa^Fpa, Aa^Fpa, Aa, Ha, Ha, Ha^Fpa, Ha^Fpa, Ha, Aa, Aa^Fpa, Aa, Aa, Aa^Fpa, Aa^Fpa, Aa^Fpa, Aa^Fpa, Aa^Fpa, Ha^Fpa, Ha^Fpa, Ha
Ai, Aa^Fpa, Aa^Fpa, Aa^Fpa, Aa^Fpa, Aa^Fpa, Aa^Fpa, Aa^Fpa, Aa, Aa^Fpa, Aa^Vca, Aa^Fpa, Aa, Aa, Aa, Aa, Aa, Rb, Re^Esa, Re, Re, Aa, Aa, Aa, Aa^Fpa, Aa^Vha, Aa^Fpa, Aa^Fpa, Ha, Ha, Aa, Aa, Aa^Fpa, Aa^Fpa, Aa^Fpa, Aa^Fpa, Aa^Fpa, Aa^Fpa, Ha^Fpa, Ha, Ha, Ha
Ai, Ai, Ai, Ai, Ai, Aa^Fpa, Aa, Aa, Aa^Fpa, Aa, Aa, Aa, Aa, Aa, Aa, Aa^Fpa, Aa, Aa, Rra, Re, Re, Aa, Aa, Aa, Aa^Fpa, Aa^Fpa, Aa^Fpa, Aa^Fpa, Aa, Aa, Aa^Fpa, Aa^Fpa, Aa^Fpa, Aa^Fpa, Aa^Fpa, Aa^Fpa, Ha, Ha^Fpa, Ha, Ha, Ha, Ha
Aa^Fpa, Ww, Ww, Ai, Ww, Ai, Ai, Ww, Ww, Ai, Ai, Ww, Ai, Aa, Aa^Fpa, Aa, Aa, Aa, Aa, Re, Re, Aa, Aa, Aa^Fpa, Aa^Fpa, Aa, Aa, Aa, Aa, Aa, Aa^Fpa, Aa^Fpa, Aa^Fpa, Aa^Fpa, Aa, Aa, Ha, Ha, Ha, Ha, Ha, Ha
Aa, Aa, Aa^Fpa, Aa^Fpa, Aa, Ww, Ww, Ai, Ww, Ww, Ai, Ai, Ai, Ww, Ww, Ww, Ww, Aa, Aa, Rp, Rra, Rra, Aa, Aa^Fpa, Aa, Aa^Fpa, Aa, Aa^Fpa, Aa^Fpa, Aa, Aa, Aa^Vha, Aa, Aa, Aa, Aa, Ha, Ha, Ha^Fpa, Ha, Aa, Aa
Aa, Aa, Aa, Aa^Fpa, Aa^Esa, Aa, Aa, Aa, Aa, Aa, Aa, Aa, Aa, Ai, Ai, Ai, Ai, Ww, Ww, Ai, Ai, Ww^Bw|, Ww, Aa, Ww, Aa, Ww, Aa^Fpa, Ai, Aa^Fpa, Ai, Aa, Aa, Aa, Aa^Fpa, Aa, Aa, Ha^Fpa, Aa^Fpa, Aa^Fpa, Aa, Aa
Aa^Fpa, Aa^Fpa, Aa^Fpa, Aa, Aa, Aa, Aa, Aa^Fpa, Aa, Aa, Aa, Aa^Fpa, Aa, Aa, Aa, Aa, Aa, Ai, Aa, Ww, Aa, Ww^Bw|, Ai, Ai, Ai, Ww, Ww, Ww, Ww, Ai, Ww, Ai, Ai, Ai, Ai, Aa, Aa, Aa, Aa, Aa, Aa, Aa
Aa^Fpa, Aa^Fpa, Aa^Fpa, Aa^Fpa, Aa^Fpa, Aa, Aa^Fpa, Aa, Aa^Fpa, Aa^Fpa, Aa^Fpa, Aa, Aa, Aa, Aa, Aa, Aa^Fpa, Aa, Aa, Aa, Rra, Rra, Rra, Aa, Aa, Aa, Aa, Aa, Aa, Ww, Aa, Ww, Aa, Ww, Ww, Ai, Ai, Aa, Ww, Aa, Aa, Aa
Aa^Fpa, Aa^Fpa, Aa^Fpa, Aa^Fpa, Aa^Fpa, Aa^Fpa, Aa^Fpa, Aa^Fpa, Aa^Fpa, Aa^Fpa, Aa^Fpa, Aa^Fpa, Aa^Fpa, Aa, Aa^Fpa, Aa, Aa^Fpa, Aa^Fpa, Aa^Fpa, Aa^Vca, Aa, Rra, Re, Re, Aa, Aa, Aa, Aa, Aa, Ww, Aa, Aa, Aa, Aa, Aa, Ai, Ai, Ww, Ai, Ww, Ai, Aa
Ha^Fpa, Aa^Fpa, Ha^Fpa, Aa^Fpa, Aa^Fpa, Aa^Fpa, Aa^Fpa, Aa^Fpa, Aa^Fpa, Aa^Fpa, Aa^Fpa, Aa^Fpa, Aa^Fpa, Aa, Aa, Aa, Aa^Fpa, Aa^Fpa, Aa^Fpa, Aa^Fpa, Aa, Re, Re, Re, Rra, Aa, Aa, Aa, Aa^Fpa, Ai, Aa, Aa, Aa, Aa, Aa^Fpa, Aa^Fpa, Aa, Ai, Ai, Ai, Ai, Ww
Ha^Fpa, Ha^Fpa, Ha^Fpa, Ha^Fpa, Ha^Fpa, Aa^Fpa, Aa^Fpa, Aa^Fpa, Aa^Fpa, Aa^Fpa, Aa^Fpa, Aa^Fpa, Aa^Fpa, Aa, Aa, Aa, Aa, Aa^Fpa, Aa^Fpa, Aa^Fpa, Aa, Rb, Re, Re^Esa, Re, Aa, Aa, Aa, Aa^Fpa, Ai, Aa^Vha, Aa, Aa, Aa, Aa, Aa^Fpa, Aa, Aa, Aa, Aa^Fpa, Aa, Ai
Ha, Ha^Fpa, Ha, Ha^Fpa, Ha, Ha^Fpa, Ha, Aa^Fpa, Aa^Fpa, Aa^Fpa, Aa^Fpa, Aa^Vha, Aa, Aa, Aa, Aa, Aa, Aa, Aa, Aa, Re, Re, Aa, Rb, Re, Re, Aa, Aa, Aa, Ai, Ai, Aa^Fpa, Aa^Fpa, Aa, Aa, Aa, Aa^Fpa, Aa, Aa, Aa, Aa, Aa
Ha, Ha, Ha, Ha, Ha, Ha, Ha, Ha, Aa^Fpa, Aa^Fpa, Aa^Fpa, Aa^Fpa, Aa^Fpa, Aa, Aa^Fpa, Aa^Fpa, Aa, Aa, Re, Re, Aa, Aa, Aa, Rb, Rb, Re, Aa, Aa, Aa, Aa, Aa, Aa^Fpa, Aa, Aa, Aa, Aa, Aa, Aa, Aa, Aa, Aa, Aa
Ms, Ha, Ha, Ha, Ha^Fpa, Ha, Ha^Fpa, Ha^Fpa, Ha^Fpa, Aa^Fpa, Aa^Fpa, Aa^Fpa, Aa^Fpa, Aa, Aa, Aa, Aa, Re, Re, Aa, Aa, Aa, Aa^Fpa, Aa^Fpa, Re, Re, Aa, Aa, Aa, Aa, Aa, Aa, Aa^Fpa, Aa, Aa^Fpa, Aa, Aa, Aa, Aa, Aa, Ha, Ha
Ms, Ms, Ha, Ha, Ha, Ha^Fpa, Ha^Fpa, Ha^Fpa, Ha^Fpa, Aa^Fpa, Aa^Fpa, Aa^Fpa, Aa^Fpa, Aa, Aa, Aa, Rb, Rb, Aa^Fpa, Aa, Aa^Fpa, Aa^Fpa, Aa^Fpa, Ha^Fpa, Re, Re, Aa, Aa, Aa^Fpa, Aa^Esa, Aa, Aa^Fpa, Aa^Fpa, Aa, Aa, Aa, Ha^Vhha, Aa, Ha, Ha, Ms, Ha
Ha, Ha, Ha, Ha, Ha, Ha, Ha, Ha^Fpa, Ha^Fpa, Aa^Fpa, Aa^Fpa, Aa^Fpa, Aa^Fpa, Aa, Aa, Aa, Re, Ha^Fpa, Aa^Fpa, Aa, Aa^Fpa, Aa^Fpa, Aa^Fpa, Aa^Fpa, Re, Re, Aa, Aa^Fpa, Aa^Fpa, Aa, Aa, Aa, Aa^Fpa, Aa, Ha, Ha, Ha, Ha, Ha, Ha, Ms, Ms
Ha^Fpa, Ha, Ha, Ha, Ms, Ms, Ha, Ha, Ha, Aa^Fpa, Aa^Fpa, Aa^Fpa, Aa^Fpa, Aa, Aa, Re, Aa^Vca, Ha, Aa, Aa^Fpa, Aa^Fpa, Aa^Fpa, Aa, Aa, Re, Rb, Re^Esa, Aa^Fpa, Aa^Fpa, Aa, Aa, Aa^Fpa, Aa^Fpa, Ha^Fpa, Ha, Ha, Ha^Fpa, Ha, Ha, Ha, Ha, Ms
Ha^Fpa, Ha^Fpa, Ha, Ms, Ha, Ms, Ha, Ha, Ha, Aa^Fpa, Aa^Fpa, Aa^Fpa, Aa, Aa, Rb, Rb, Aa, Ha, Aa, Aa^Fpa, Aa^Fpa, Aa^Fpa, Aa, Aa, Re, Rp, Aa, Aa, Aa, Aa, Ha, Aa, Aa, Aa, Aa, Aa^Fpa, Aa^Fpa, Aa^Fpa, Aa, Ha, Ha, Ha
Ha, Ha, Ha, Ha, Ha, Ha, Ha^Fpa, Ha, Ha^Fpa, Aa^Fpa, Aa^Fpa, Aa^Fpa, Aa, Aa, Re, Aa, Aa, Aa, Aa, Aa, Aa, Aa, Aa^Esa, Aa, Aa, Re, Aa, Aa, Aa, Aa, Aa, Aa^Fpa, Aa^Fpa, Aa, Ha, Ha^Fpa, Aa, Aa, Aa^Fpa, Ha^Fpa, Ha, Ha
Ha, Ha, Ha, Ha, Ha, Ha, Ha, Ha^Fpa, Aa^Fpa, Aa^Fpa, Aa, Aa^Fpa, Aa, Aa, Re, Aa^Fpa, Aa^Fpa, Aa^Fpa, Ai, Ai, Ai, Aa, Aa, Aa, Aa, Rb, Re, Aa, Aa, Aa, Aa, Aa^Fpa, Aa, Aa, Aa, Ha, Aa, Aa, Aa^Fpa, Aa^Fpa, Aa, Ha
Ha^Fpa, Ha^Fpa, Ha, Ha, Ha, Ha, Ha, Ha^Fpa, Aa^Fpa, Aa^Fpa, Aa, Aa, Aa, Aa, Re, Aa^Fpa, Aa^Fpa, Aa^Fpa, Ai, Ai, Ai, Ai, Ai, Aa, Aa, Aa, Re, Rp^Esa, Rp, Aa, Aa, Aa, Aa^Fpa, Aa, Aa, Aa, Aa, Aa, Aa, Aa, Aa, Aa
Ha, Ha, Ha, Ha, Ha^Fpa, Ha, Ha, Ha^Fpa, Aa^Fpa, Aa^Fpa, Aa, Aa, Aa, Aa^Vca, Re, Aa, Aa, Aa^Fpa, Aa^Fpa, Ai, Ai, Ai, Aa^Fpa, Aa, Aa, Aa, Aa^Fpa, Re, Re, Aa, Aa, Aa, Aa, Aa, Aa, Aa^Fpa, Ai, Aa, Aa, Aa, Aa, Aa
Ha, Ha, Ha, Ha^Fpa, Ha^Fpa, Ha^Fpa, Ha^Fpa, Aa^Fpa, Aa^Fpa, Aa, Aa^Fpa, Aa, Aa, Re, Re, Aa, Aa, Aa, Aa, Aa^Fpa, Aa, Aa, Aa, Aa, Aa^Fpa, Aa^Fpa, Aa^Fpa, Aa, Rb, Aa, Aa, Aa, Aa^Esa, Aa, Aa, Ai, Ai, Ai, Aa, Aa, Aa, Aa
Ha, 6 Ha, Ha, Ha, Ha, Ha^Fpa, Aa^Fpa, Aa^Fpa, Aa, Aa, Aa, Aa, Aa, Rb, Re, Aa^Fpa, Aa^Fpa, Aa, Aa, Aa, Aa^Fpa, Aa, Aa, Aa, Aa^Fpa, Re, Re, Aa^Fpa, Rb, Aa, Aa, Aa, Aa, Aa, Aa, Ai, Aa, Aa, Aa, Aa, Aa^Fpa, Aa^Fpa
Ha, Ha, Ha^Fpa, Ha, Aa^Fpa, Aa^Fpa, Aa^Fpa, Aa, Aa, Aa, Aa, Aa, Aa^Fpa, Aa^Fpa, Re, Aa^Fpa, Aa^Fpa, Aa, Aa, Aa, Re, Aa^Fpa, Re, Aa, Re, Aa^Fpa, Aa^Fpa, Aa^Fpa, Rb, Aa, Aa, Aa, Aa^Fpa, Aa, Aa, Aa, Ha, Aa, Aa, Aa, Aa^Fpa, Aa^Fpa
Aa^Fpa, Ha^Fpa, Aa^Fpa, Aa^Fpa, Aa^Fpa, Aa^Fpa, Aa, Aa, Aa, Aa, Aa^Fpa, Aa^Fpa, Aa^Fpa, Aa^Fpa, Re, Re, Re, Re, Re, Aa, Aa^Vca, Re, Aa, Re, Re, Aa^Vca, Aa, Re, Rb, Re, Aa, Aa^Fpa, Aa^Fpa, Aa^Fpa, Aa, Ha, Ha^Fpa, Aa^Fpa, Aa, Aa, Aa, Aa^Fpa
Aa^Fpa, Aa^Fpa, Aa^Fpa, Aa^Fpa, Aa, Aa, Aa, Aa, Aa, Aa, Aa, Aa^Fpa, Aa^Fpa, Aa^Fpa, Re, Re^Esa, Re, Re, Aa^Fpa, Re, Re, Re, Aa, Aa, Aa, Re, Re, Re, Rb^Esa, Re, Aa, Aa, Aa, Aa, Aa, Aa, Aa, Aa^Fpa, Aa, Aa, Aa, Aa
Aa, Aa^Fpa, Aa, Aa^Fpa, Aa, Aa, Aa, Aa^Fpa, Aa, Aa, Aa, Aa, Aa, Aa^Fpa, Rb, Rb, Aa^Fpa, Aa^Fpa, Aa, Aa^Fpa, Aa, Aa, Rb, Rb^Esa, Rb, Aa, Rb, Rb, Rb, Rb, Aa, Aa, Aa, Aa^Esa, Aa, Aa^Fpa, Aa, Aa, Aa, Aa, Aa, Aa
Aa^Fpa, Aa, Aa, Aa, Aa, Aa, Aa^Esa, Aa, Aa, Aa^Fpa, Aa^Fpa, Aa, Aa, Aa, Aa, Rb, Aa, Aa^Fpa, Aa^Fpa, Aa^Fpa, Aa, Aa, Rb, Rb, Rb, Rb, Aa, Aa, Aa, Rb, Rb, Aa, Aa, Aa, Aa, Aa, Aa, Aa, Aa^Fpa, Aa^Fpa, Aa, Aa
Aa^Fpa, Aa, Aa, Aa, Aa, Aa, Aa, Aa, Aa, Aa^Fpa, Aa, Aa, Aa, Aa, Aa, Rb, Rb, Aa, Rb, Rb, Rb, Rb, Aa, Rb, Aa, Aa, Aa^Esa, Aa, Aa, Aa, Rb, Aa, Aa, Aa, Aa, Aa, Aa, Aa, Aa^Fpa, Aa^Fpa, Aa, Aa
Aa, Aa, Aa^Fpa, Aa, Aa^Fpa, Aa^Fpa, Aa^Fpa, Aa, Aa^Fpa, Aa, Aa^Fpa, Aa, Aa^Fpa, Aa^Fpa, Aa^Fpa, Aa, Aa, Rb, Rb, Rb, Aa^Fpa, Aa, Aa, Aa, Aa, Aa, Aa, Aa, Aa, Aa, Aa, Rb, Aa, Aa, Aa^Fpa, Aa, Aa, Aa, Aa, Aa^Fpa, Aa^Fpa, Aa^Fpa
Aa, Aa, Aa^Fpa, Aa^Fpa, Aa^Fpa, Aa^Fpa, Aa^Fpa, Aa^Fpa, Aa^Fpa, Aa^Fpa, Aa, Aa, Aa, Aa^Fpa, Aa, Aa, Aa, Rb, Rb, Aa^Fpa, Aa^Fpa, Aa, Aa^Fpa, Aa^Fpa, Aa^Fpa, Aa, Aa, Aa, Aa^Fpa, Aa^Fpa, Aa^Fpa, Rb, Aa, Aa, Aa^Fpa, Aa^Fpa, Aa, Aa, Aa, Aa, Aa, Aa^Fpa
Aa, Aa, Aa, Aa^Fpa, Aa^Fpa, Aa^Fpa, Aa^Fpa, Aa^Fpa, Aa, Aa, Aa, Aa, Aa, Aa^Esa, Aa, Aa, Rb, Rb, Rb, Aa, Aa, Aa, Aa, Aa^Fpa, Aa, Aa, Aa, Rb, Aa^Fpa, Aa^Fpa, Aa^Fpa, Rb, Aa, Aa, Aa, Aa, Aa, Aa, Aa, Aa, Aa, Aa
Aa, Aa, Aa, Aa^Fpa, Aa^Fpa, Aa^Fpa, Aa, Aa, Aa, Aa, Aa, Aa, Aa^Fpa, Aa, Rb, Rb, Rb, Rb, Aa, Aa, Aa, Aa, Aa, Aa, Aa^Esa, Aa, Aa, Rb, Aa^Fpa, Aa^Fpa, Aa^Fpa, Aa^Fpa, Aa, Aa, Aa, Aa, Aa, Aa, Aa, Aa, Aa, Aa
Aa^Fpa, Aa, Aa, Aa, Aa, Aa, Aa, Aa, Aa^Fpa, Aa^Fpa, Aa, Aa, Aa, Aa^Fpa, Rb, Rb, Rb, Aa^Fpa, Aa^Fpa, Aa^Fpa, Aa^Fpa, Aa, Aa, Aa, Aa, Aa, Aa, Rb, Rb, Aa^Fpa, Aa^Fpa, Aa^Fpa, Aa, Aa, Aa, Aa, Aa, Aa^Fpa, Aa, Aa, Aa, Aa
Aa^Fpa, Aa^Fpa, Aa, Aa, Aa, Aa, Aa, Aa, Aa^Fpa, Aa^Fpa, Aa, Aa, Aa, Aa, Rb, Rb, Rb, Aa, Aa, Aa^Fpa, Aa^Fpa, Aa, Aa, Aa, Aa^Fpa, Aa, Aa, Rb, Rb, Aa^Vca, Aa^Fpa, Aa^Fpa, Aa, Aa, Aa, Aa, Aa, Aa, Aa, Aa, Aa, Aa
Aa, Aa, Aa, Aa, Aa^Fpa, Aa, Aa, Aa, Aa, Aa, Aa, Aa, Aa, Aa, Aa, Rb, Rb, Rb, Rb, Aa, Aa, Aa, Aa, Aa, Aa, Aa, Aa, Aa, Aa, Rb, Rb, Aa, Aa, Aa, Aa, Aa, Aa^Fpa, Aa^Fpa, Aa^Fpa, Aa, Aa^Fpa, Aa^Fpa
Aa, Aa, Aa, Aa, Aa, Aa^Fpa, Aa, Aa, Aa^Fpa, Aa, Aa, Aa, Aa^Fpa, Aa^Fpa, Aa^Fpa, Aa, Aa, Rb, Rb, Aa, Aa, Aa, Aa, Aa, Aa^Fpa, Aa^Fpa, Aa^Fpa, Aa, Aa, Aa, Rb, Aa, Aa, Aa, Aa, Aa, Ai, Ss, Ss, Aa, Ai, Ai
Aa, Aa^Esa, Aa, Aa, Aa, Aa, Aa, Aa, Aa, Aa, Aa, Aa, Aa, Aa^Fpa, Aa, Aa, Aa^Vca, Rb, Rb, Rb, Rb, Aa, Aa, Aa, Aa, Aa^Fpa, Aa, Aa, Aa, Aa, Rb, Aa, Aa, Aa, Aa^Fpa, Aa^Fpa, Ai, Ss, Ai, Ai, Ai, Ai
Aa, Aa, Aa, Aa, Aa, Aa, Aa, Aa, Aa, Aa^Esa, Aa, Aa, Aa, Aa, Aa, Aa, Aa, Rb, Aa^Fpa, Aa^Fpa, Aa^Fpa, Rb, Rb, Aa, Aa, Aa, Aa, Aa, Aa, Aa, Rb, Rb, Aa, Aa, Aa, Aa^Fpa, Aa, Ai, Ai, Ai, Ai, Ai
Aa, Aa, Aa^Fpa, Aa, Aa^Fpa, Aa^Fpa, Aa^Fpa, Aa, Aa, Aa, Aa, Aa, Aa, Aa, Aa, Aa, Aa, Aa^Fpa, Aa^Fpa, Aa^Fpa, Aa^Fpa, Rb, Rb, Aa, Aa, Aa, Aa, Aa, Aa, Aa, Rb, Rb, Aa, Aa, Aa, Aa, Aa, Aa^Fpa, Aa, Aa, Aa, Ai
Aa^Fpa, Aa^Fpa, Aa^Fpa, Aa^Fpa, Aa^Fpa, Aa^Fpa, Aa^Fpa, Aa^Fpa, Aa^Fpa, Aa, Aa, Aa, Aa, Aa, Aa, Aa, Aa, Aa^Fpa, Aa^Fpa, Aa^Fpa, Aa^Fpa, Aa, Aa, Rb, Aa, Aa, Aa, Aa, Aa, Aa, Rb, Aa^Fpa, Aa^Fpa, Aa^Fpa, Aa^Fpa, Aa, Aa, Aa, Aa, Aa, Aa, Aa
