Xu, Xu, Xu, Xu, Qlf, Qlf, Qlf, Qlf, Qlf, Qlf, Uu, Uu, Uu, Uu, Uu, Uu, Uu, Uu, Uu, Qlf, Qlf, Qlf, Qlf, Qlf, Qlf, Qlf, Qlf, Qlf, Qlf, Qlf, Qlf, Qlf, Qlf, Qlf, Qlf, Qlf, Qlf, Qlf, Qlf, Qlf, Qlf, Qlf
Xu, Xu, Xu, Xu, Qlf, Qlf, Qlf, Qlf, Qlf, Qlf, Ql, Uu, Uu, Uu, Uu, Uu, Uu, Uu, Ql, Ql, Ql, Ql, Ql, Ql, Ql, Ql, Ql, Qlf, Ql, Ql, Ql, Ql, Ql, Ql, Ql, Qlf, Ql, Qlf, Qlf, Qlf, Qlf, Qlf
Xu, Xu, Xu, Xu, Qlf, Qlf, Qlf, Qlf, Ql, Ql, Ql, Ql, Ql, Uu, Uu, Uu, Uu, Uu, Ql, Ql, Ql, Ql, Ql, Ql, Ql, Ql, Ql, Ql, Ql, Ql, Ql, Ql, Ql, Ql, Ql, Ql, Ql, Ql, Ql, Qlf, Qlf, Qlf
Xu, Xu, Xu, Xu, Qlf, Qlf, Ql, Ql, Ql, Ql, Ql, Ql, Ql, Uu, Uu, Uu, Qxu, Qxu, Qxu, Qxu, Qxu, Qxu, Qxu, Qxu, Qxu, Qxu, Qxu, Qxu, Qxu, Qxu, Qxu, Qxu, Qxu, Ql, Ql, Ql, Ql, Ql, Ql, Qlf, Qlf, Qlf
Xu, Xu, Xu, Xu, Ql, Ql, Ql, Ql, Qxu, Ql, Ql, Ql, Qxu, Uu, Qxu, Qxu, Qxu, Qxu, Qxu, Qxu, Qxu, Qxu, Qxu, Qxu, Qxu, Qxu, Qxu, Qxu, Qxu, Qxu, Qxu, Qxu, Qxu, Qxu, Qxu, Ql, Ql, Ql, Ql, Qlf, Qlf, Qlf
Xu, Xu, Xu, Xu, Ql, Ql, Ql, Qxu, Qxu, Qxu, Qxu, Qxu, Qxu, Qxu, Qxu, Qxu, Qxu, Qxu, Qxu, Qxu, Qxu, Qxu, Qxu, Qxu, Uu, Qxu, Qxu, Qxu, Qxu, Qxu, Qxu, Qxu, Qxu, Qxu, Qxu, Qxu, Qxu, Ql, Ql, Ql, Qlf, Qlf
Xu, Xu, Xu, Xu, Ql, Ql, Qxu, Qxu, Qxu, Qxu, Qxu, Qxu, Qxu, Qxu, Uu, Qxu, Uu, Uu, Uu, Uu, Uu, Uu, Uu, Uu, Uu, Uu, Uu, Uu, Uu, Uu, Uu, Uu, Uu, Qxu, Qxu, Qxu, Qxu, Ql, Ql, Ql, Qlf, Qlf
Xu, Xu, Xu, Xu, Ql, Qxu, Qxu, Qxu, Qxu, Qxu, Uu, Uu, Uu, Uu, Uu, Uu, Ur, Uu, Ur, Ur, Ur, Ur, Ur, Ur, Ur, Ur, Ur, Urb, Urb, Urb, Urb, Uu, Uu, Uu, Qxu, Qxu, Qxu, Qxu, Ql, Ql, Qlf, Qlf
Xu, Xu, Xu, Xu, Ql, Qxu, Qxu, Qxu, Uu, Uu, Uu, Uu, Ur, Uu, Ur, Ur, Uu, Ur, Uu, Uu, Qxu, Qxu, Qxu, Qxu, Qxu, Qxu, Xu, Xu, Xu, Urb, Urb, Uu, Uu, Uu, Uu, Qxu, Qxu, Qxu, Ql, Ql, Qlf, Qlf
Xu, Xu, Xu, Xu, Ql, Qxu, Qxu, Qxu, Uu, Uu, Ur, Ur, Xu, Ur, Xu, Xu, Xu, Xu, Xu, Xu, Xu, Xu, Xu, Xu, Xu, Xu, Xu, Xu, Xu, Uh, Uh, Ur, Ur, Uu, Xu, Qxu, Qxu, Qxu, Ql, Ql, Qlf, Qlf
Xu, Xu, Xu, Xu, Xu, Qxu, Qxu, Qxu, Uu, Uu, Ur, Ur, Xu, Xu, Xu, Xu, Xu, Xu, Xu, Xu, Xu, Xoa, Iwr, Iwr, Iwr, Xoa, Xu, Xu, Xu, Xu, Xu, Uu, Ur, Uu, Xu, Xu, Qxu, Qxu, Ql, Ql, Qlf, Qlf
Xu, Xu, Xu, Xu, Xu, Qxu, Qxu, Qxu, Uu, Uu, Ur, Xu, Xu, Xu, Xoa, Xoa, Xoa, Xu, Xu, Xu, Xu, Iwr, Iwr, Iwr, Iwr, Iwr, Xu, Xu, Xu, Xu, Xoa, Uu, Ur, Xoa, Xoa, Xu, Qxu, Qxu, Ql, Ql, Qlf, Qlf
Xu, Xu, Xu, Xu, Xu, Qxu, Qxu, Qxu, Uu, Ur, Xu, Xu, Xu, Xoa, Ias, Uu^Vud, Ias, Uu^Vud, Xoa, Xu, Xu, Cud, Cud, Cud, Cud, Cud, Xu, Xu, Xu, Xoa, Uu, Ur, Ur, Uu, Uh, Xu, Qxu, Qxu, Ql, Ql, Qlf, Qlf
Xu, Xu, Xu, Xu, Xu, Xu, Qxu, Qxu, Uu, Ur, Xoa, Xu, Xu, Uu^Vud, Ias, Uu, Uu, Ias, Ias, Xu, Xu, Xoa, Uh, Urb, Uh, Xoa, Xu, Xu, Xu, Uh, Uu, Ur, Uu, Uu, Uh, Qxu, Qxu, Qxu, Ql, Ql, Qlf, Qlf
Xu, Xu, Xu, Xu, Xu, Xu, Qxu, Qxu, Uu, Ias, Xoa, Xu, Xu, Ias, Ias, Ur, Ur, Uu, Uu, Xoa, Uh, Uh, Urb, Urb, Uh, Xu, Xu, Xu, Uh, Uh, Ur, Ur, Uu, Uu, Uu, Qxu, Qxu, Qxu, Ql, Ql, Qlf, Qlf
Xu, Xu, Xu, Xu, Xu, Xu, Qxu, Qxu, Uu, Ias, Xoa, Xu, Xu, Uu, Uu, Ur, Ias, Uu^Vud, Uu, Ias, Ur, Urb, Urb, Uu, Uu, Xu, Xu, Uh, Uu, Uu, Ur, Uu, Uu, Uu, Uu, Qxu, Qxu, Qxu, Ql, Ql, Qlf, Qlf
Xu, Xu, Xu, Xu, Xu, Xu, Qxu, Qxu, Uu, Ias, Xoa, Xu, Xu, Uu, Ias, Ur, Ur, Ias, Ur, Ur, Urb, Urb, Uh, Uh, Xu, Xu, Xu, Xu, Uu, Ur, Uu, Uu, Uh, Uh, Uu, Qxu, Qxu, Qxu, Ql, Ql, Qlf, Qlf
Xu, Xu, Xu, Xu, Xu, Xu, Qxu, Qxu, Uu, Ias, Xoa, Xu, Xu, Uu, Ias, Ias, Uh, Ur, Uh, Uh, Uh, Uh, Xu, Xu, Xu, Xu, Xu, Uu^Vud, Uh, Urb, Uu, Uh, Uh, Uu, Qxu, Qxu, Qxu, Qxu, Ql, Ql, Qlf, Qlf
Uh, Xu, Xu, Xu, Xu, Qxu, Qxu, Qxu, Ias, Ias, Xoa, Xu, Xu, Uh, Uu, Ur, Uh, Uh, Xu, Xu, Xu, Xu, Xu, Xu, Qxu, Qxu, Uh, Uh, Urb, Urb, Uu, Uh, Uu, Uu, Qxu, Qxu, Qxu, Ql, Ql, Ql, Qlf, Qlf
Ww, Uh, Uh, Xu, Xu, Qxu, Qxu, Qxu, Ur, Ias, Ias, Xoa, Xu, Uh, Uh, Ur, Ias, Xoa, Xoa, Xu, Xu, Xu, Xu, Xu, Qxu, Qxu, Uu, Uu, Uu, Urb, Uu, Uu, Qxu, Qxu, Qxu, Qxu, Ql, Ql, Qlf, Qlf, Qlf, Qlf
Wwf, Uh, Ww, Uh, Uh, Qxu, Qxu, Qxu, Ias, Uu, Uu, Xu, Xu, Xu, Uh, Ur, Uu, Ias, Ias, Xu, Xu, Uh, Uh, Qxu, Uu, Uu, Uu, Uu, Ur, Ur, Uu, Uu, Qxu, Qxu, Qxu, Ql, Ql, Ql, Qlf, Qlf, Qlf, Qlf
Wwf, Wwf, Wwf, Ww, Wwf, Qxu, Qxu, Qxu, Ur, Uu, Ias, Xoa, Xoa, Uh, Uh, Ur, Uu, Uu, Uu, Xu, Xu, Xu, Qxu, Qxu, Qxu, Qxu, Qxu, Uu, Uu, Ur, Uu, Uu, Qxu, Qxu, Qxu, Ql, Ql, Ql, Qlf, Qlf, Xu, Xu
Uh, Wwf, Ww, Wwf, Wwf, Qxu, Qxu, Qxu, Ur, Ias, Ur, Ias, Uh, Uh, 3 Kay, Cay, Qxu, Uu, Uu, Xu, Xu, Xu, Qxu, Qxu, Qxu, Qxu, Qxu, Uu, Uu, Ur, Uu, Uu, Qxu, Qxu, Qxu, Ql, Qlf, Qlf, Xu, Xu, Xu, Xu
Xu, Uh, Uh, Ww, Uh, Qxu, Qxu, Qxu, Uu, Ias, Ias, Uu, Ur, Cay, Cay, Cay, Qxu, Qxu, Uu, Uu, Xu, Xu, Xu, Qxu, Qxu, Qxu, Xu, Uu, Cay, Ur, Uu, Uu, Qxu, Qxu, Qxu, Ql, Ql, Ql, Ql, Xu, Xu, Xu
Qlf, Xu, Qlf, Uh, Ql, Qxu, Qxu, Qxu, Uu, Uu, Uu, Ur, Ur, Ur, Xoa, Qxu, Xu, Qxu, Uu, Uu, Xu, Xu, Xu, Xu, Qxu, Xu, Uu^Vu, Xu, Ur, Ur, Xu, Xu, Qxu, Qxu, Qxu, Ql, Ql, Ql, Ql, Xu, Xu, Xu
Qlf, Qlf, Qlf, Ql, Ql, Qxu, Qxu, Qxu, Uu, Uu, Uu, Ur, Ias, Ias, Ias, Xoa, Xoa, Xu, Uu, Uu, Uh, Xu, Xu, Xu, Xu, Qxu, Uu, Uu, Ur, Uu, Uu, Xu, Qxu, Qxu, Qxu, Ql, Ql, Ql, Xu, Xu, Xu, Xu
Qlf, Qlf, Qlf, Ql, Ql, Qxu, Qxu, Qxu, Qxu, Uu, Uu, Uu, Uu, Ur, Ur, Ias, Uu, Uu, Uu, Uu, Uu, Uh, Uh, Xu, Xu, Qxu, Ur, Uu, Ur, Uu, Uu, Uu, Qxu, Qxu, Qxu, Ql, Xu, Xu, Xu, Xu, Xu, Xu
Qlf, Qlf, Qlf, Ql, Ql, Qxu, Qxu, Qxu, Qxu, Qxu, Qxu, Uu, Uu, Uu, Uu, Ur, Cay, Ur, Ur, Uu, Uu, Uh, Uh, Xu, Xu, Qxu, Ur, Ur, Ur, Ur, Uu, Uu, Qxu, Qxu, Ql, Ql, Xu, Xu, Xu, Xu, Xu, Xu
Qlf, Qlf, Qlf, Ql, Ql, Ql, Ql, Qxu, Qxu, Qxu, Qxu, Qxu, Qxu, Uu, Uu, Cay, Kay, Cay, Uu, Ur, Uu, Uh, Xu, Xu, Xu, Xu, Ur, Ur, Ur, Ur, Uu, Qxu, Qxu, Qxu, Ql, Ql, Xu, Xu, Xu, Xu, Xu, Xu
Qlf, Qlf, Qlf, Ql, Ql, Ql, Ql, Ql, Ql, Qxu, Qxu, Qxu, Qxu, Qxu, Qxu, Uu, Uu, Cay, Uu, Rr, Uu, Xu, Xu, Xu, Uu, Uu, Ur, Ur, Ur, Uu, Uu, Qxu, Qxu, Qxu, Ql, Xu, Xu, Xu, Xu, Xu, Xu, Xu
Qlf, Qlf, Qlf, Ql, Ql, Ql, Ql, Ql, Ql, Ql, Ql, Qxu, Qxu, Qxu, Qxu, Qxu, Qxu, Uu, Uu^Vud, Rr, Uu^Vud, Xu, Xu, Xu, Cay, Uu, Ur, Ur, Ur, Uu, Cay, Qxu, Qxu, Qxu, Xu, Xu, Xu, Xu, Xu, Xu, Xu, Xu
Qlf, Qlf, Qlf, Qlf, Qlf, Qlf, Qlf, Ql, Ql, Ql, Ql, Ql, Ql, Qxu, Qxu, Qxu, Qxu, Uu, Uu^Vud, Rr, Uu^Vud, Uu^Vud, Xu, Xu, Xu, Cay, Uu, Ur, Uu, Cay, Cay, Qxu, Qxu, Qxu, Xu, Xu, Xu, Xu, Xu, Xu, Xu, Xu
Qlf, Qlf, Qlf, Qlf, Qlf, Qlf, Qlf, Qlf, Qlf, Qlf, Qlf, Ql, Ql, Ql, Xu, Qxu, Xu, Uu, Uu^Vud, Rr, Uh, Xu, Xu, Xu, Xu, Cay, Uu, Ur, Uu, Cay, Xu, Cay, Xu, Xu, Xu, Xu, Xu, Xu, Xu, Xu, Xu, Xu
Qlf, Qlf, Qlf, Qlf, Qlf, Qlf, Xu, Qlf, Xu, Qlf, Xu, Qlf, Xu, Xu, Xu, Xu, Xu, Xu, Xu, Uh, Uh, Xu, Xu, Xoa, Uu, Uu, Ias, Ias, Xu, Xu, Xu, Xu, Xu, Xu, Xu, Xu, Xu, Xu, Xu, Xu, Xu, Xu
Xu, Qlf, Xu, Xu, Xu, Xu, Xu, Xu, Xu, Xu, Xu, Xu, Xu, Xu, Xu, Xu, Xu, Xu, Xu, Uh, Uh, Uh, Uu^Vud, Uu, Uu, Ias, Ias, Uu, Xu, Xu, Xu, Xu, Xu, Xu, Xu, Xu, Xu, Xu, Xu, Xu, Xu, Xu
Xu, Xu, Xu, Xu, Xu, Xu, Xoa, Xu, Xu, Xu, Xu, Xu, Xu, Xu, Uh, Xu, Xu, Xu, Xu, Xu, Uh, Uh, Uu, Uu, Ur, Ur, Uu, Uu, Xu, Xu, Xu, Xu, Xu, Xu, Uu, Xu, Cay, Xu, Xu, Xu, Xu, Xu
Xu, Xu, Xu, Xu, Uh, Xu, Uu, Uu^Vud, Uu, Cay, Uu, Uu, Uu, Uh, Uh^Edt, Uh, Uh, Xu, Xu, Xu, Uu, Uu, Ias, Ias, Uu, Uu, Xu, Xu, Xu, Xu, Xu, Uh, Uu, Uu, Ur, Ur, Ur, Ur, Ur, Xu, Xu, Xu
Xu, Xu, Uh, Uh, Ur, Uu, Ur, Uu, Ias, Uu, Uu, Uu, Uu, Uu^Edt, Uu^Edt, Uh^Edt, Uh, Xu, Xu, Xu, Uu, Ias, Uu, Uu, Uu, Uu, Xu, Xu, Xu, Xu, Uh, Uu, Ur, Ur, Uu, Uu^Vud, Uu, Ur, Ur, Xu, Xu, Xu
Xu, Uh, Uu, Uu, Ur, Ur, Uu, Ias, Uu, Ias, Ias, Ias, Ias, Ias^Edt, Ias, Uu^Edt, Uu, Uh, Uu, Cay, Ias, Ur, Uu, Uu, Xu, Xu, Xu, Xu, Uh, Uh, Ur, Ur, Uu, Uu, Cay, Uu, Uu, Wwf, Ur, Xu, Xu, Xu
Xu, Uu, Ias, Ur, Uu, Uu, Uu, Uu, Uu, Cay, Uu, Uu, Uu, Uu, Uu^Es, Ur, Ur, Uu, Ur, Ur, Cay, Uu, Uu, Uu, Xu, Xu, Xu, Xu, Uh, Ur, Ur, Uu, Xu, Xu, Xu, Uu, Wwf, Wwf, Ur, Wwrg, Xu, Xu
Xu, Xu, Ias, Uu, Uh, Uu, Xu, Xu, Xu, Xu, Xu, Uu, Xu, Uu, Uu, Uu, Uu, Ias, Ur, Uu, Uu, Uu, Xu, Xu, Xu, Xu, Uh, Uh, Wwg, Ur, Wwg, Wwf, Xu, Xu, Xu, Uu, Wwf, Tb^Tf, Wwf, Wwrg, Wwrg, Xu
Xu, Ias, Uu, Uh, Uh, Xu, Xu, Xu, Uu^Edt, Xu, Xu, Xu, Xu, Xu, Xue, Xue, Xue, Xue, Uu, Uu, Cay, Xu, Xu, Xu, Xu, Xu, Uh, Uh, Wwg, Wwg, Wog, Wwg, Wog, Xu, Xu, Uu, Wwg, Tb^Tf, Wwf, Wwg, Wwrg, Xu
Xu, Ias, Uu, Uh, Uh, Xu, Xue, Uu^Edt, Uu^Edt, Uu^Edt, Uu, Uu^Es, Uu^Es, Xue, Uu^Dr, Uu, Uu^Dr, Xu, Xue, Uu, Xu, Xu, Xu, Xu, Uu, Uu, Wwf, Wwf, Ur, Wwg, Wwf, Wog, Wog, Xu, Xu, Uh, Wog, Wog, Wog, Wwg, Wwrg, Xu
Xu, Ur, Uu, Uh, Xu, Xue, Uu, Uu, Uu, Uu^Edt, Uu, Uu^Dr, Uu^Es, Uu^Es, Uu^Es, Uu^Es, Uu^Dr, Uu, Xue, Xu, Xu, Xu, Xu, Xu, Uu, Uu, Ur, Ur, Uu, Uu, Uu^Vud, Xu, Xu, Wog, Wog, Wwrg, Wog, Wog, Wwg, Wwg, Xu, Xu
Xu, Ur, Uu, Uu, Xoa, Xue, Xue, Uu, Uu, Uu, Uu, Uu, Xue, Uu^Es, Uu^Es, Uu^Es, Xue, Xue, Xue, Xu, Xue, Xu, Uu, Uu, Ur, Ur, Uu, Uu, Xu, Xu, Xu, Xu, Xu, Xu, Wwrg, Wog, Wwg, Wog, Wwg, Xu, Xu, Xu
Xu, Ur, Ias, Uu, Uu, Xoa, Xoa, Xue, Xue, Xue, Xue, Xu, Xu, Xue, Xue, Xu, Xue, Xue, Xue, Xue, Uu, Uu, Ias, Ias, Uu, Uu, Xu, Xu, Xu, Xu, Xu, Xu, Xu, Xu, Wwrg, Wog, Wwf, Wog, Wog, Xu, Wog, Xu
Xu, Uu, Ias, Uu, Uu, Uu, Uu, Uu^Dr, Uu, Uh^Dr, Uh, Uh, Uh, Uh, Uu^Es, Uu^Dr, Ias^Es, Uu^Dr, Ur, Uu, Ur, Ias, Uu, Uu, Xu, Xu, Xu, Xu, Xu, Xu, Xu, Xu, Uh, Wwrg, Wwf, Urb, Wog, Wog, Xu, Wog, Wog, Wog
Xu, Xu, Xu, Ias, Ias, Ias, Ias, Uu, Ias, Uu, Uu, Uu, Ias, Ur, Ur, Ias^Es, Uu^Dr, Ias, Ur, Ur, Uu, Ur, Uu, Uu^Dr, Xue, Xue, Xue, Xu, Uu^Vu, Xu, Uh, Uh, Uu, Wwf, Urb, Urb, Xu, Xu, Xu, Xu, Xu, Wog
Xu, Xu, Xu, Uu^Vud, Xu, Uu, Uu, Ur, Uu, Ias, Ur, Ur, Uu, Uu, Uu^Dr, Uu, Uu, Cay, Uu, Uu, Uu, Uu, Xu, Xue, Uu, Uu, Xue, Xu, Uu, Uu, Uu, Uu, Urb, Urb, Tb^Tf, Tb^Tf, Xu, Xu, Xu, Xu, Xu, Xu
Xu, Xu, Xu, Xu, Xu, Xu, Xu, Uh, Uh, Uu, Uu^Vud, Uu, Uh, Uh, Uu^Dr, Uu, Uu, Uu, Uu, Uu, Tb^Tf, Xu, Xu, Xu, Xue, Xue, Uu^Dr, Uu, Urb, Urb, Urb, Urb, Tb^Tf, Uu, Xu, Xu, Xu, Xu, Xu, Xu, Xu, Xu
Xu, Xu, Xu, Xu, Xu, Xu, Uu^Edt, Xu, Xu, Uh, Xu, Uh, Xue, Xue, Xu, Xue, Xue, Uu^Dr, Uu, Uu, Xu, Xu, Uu, Xu, Uu, Uu^Dr, Urb, Urb, Uu, Urb, Uu, Uu, Uh, Xu, Xu, Xu, Xu, Xu, Xu, Xu, Xu, Xu
Xu, Xu, Xu, Xu, Xu, Uu^Edt, Uu^Edt, Uu, Uu, Xue, Uu, Xue, Uu^Dr, Uu, Uu, Uu^Dr, Uu^Dr, Xue, Xu, Xu, Uu, Uu, Uu, Xu, Xu, Uu, Urb, Uu, Cay, Uu, Uu, Uu, Uh, Xu, Xu, Xu, Xu, Xu, Xu, Xu, Xu, Xu
Xu, Xu, Xu, Xu, Xu, Uu^Edt, Uu^Edt, Uu, Xu, Uu, Xue, Uu, Xu, Xue, Xue, Xu, Xue, Uu, Uu, Uu, Xu, Uu, Xu, Xu, Xoa, Uu, Ias, Cay, Cay^Es, Cay, Ias, Uh, Uh, Xu, Xu, Xu, Xu, Xu, Xu, Xu, Xu, Xu
Xu, Xu, Xu, Xu, Xu, Xu, Xu, Xu, Xue, Xue, Uh^Dr, Xue, Uh, Uh^Dr, Uh, Uh^Dr, Uu, Xue, Xu, Xu, Tb^Tf, Xu, Xu, Xu, Uu, Uu, Urb, Cay^Es, Cay, Cay, Uu, Uu, Uh, Uh, Xu, Xu, Xu, Xu, Xu, Xu, Xu, Xu
Qxu, Xu, Xu, Xu, Xu, Xu, Xu, Xu, Xue, Uh, Uu, Uh, Uh, Uh, Uu, Uu, Uu, Uu, Cay, Uu, Uu, Xoa, Xoa, Uu, Uu, Ias, Urb, Uu, Uu, Ias, Uh, Uh, Xu, Xu, Xu, Xu, Xoa, Xu, Xu, Xu, Xu, Xu
Qxu, Xu, Xu, Xu, Xu, Xu, Xoa, Xoa, Uu, Uu, Uu, Uu, Uu, Uu, Ur, Uu, Uu, Uu, Cay, Uu, Uu, Uu, Ias, Uu, Urb, Urb, Ias, Uu, Uu, Uh, Xu, Xu, Xu, Xu, Xu, Xoa, Uu, Wog, Wog, Wwrg, Wwrg, Xu
Qxu, Qxu, Qxu, Xu, Xu, Xu, Uu^Vu, Uu, Uu, Uu, Ur, Ur, Ur, Ur, Ias, Ias, Uu, Uu, Cay, Uu, Uu, Ias, Uu^Vud, Urb, Uu, Uu, Ias, Uu, Uu, Xu, Xu, Xu, Xu, Xu, Uu, Uu, Urb, Wwg, Wog, Wog, Wwrg, Xu
Xu, Qxu, Qxu, Qxu, Qxu, Xu, Uu, Uu, Uu, Uu, Ur, Uu, Uu, Ur, Ias, Ias, Ias, Uu, Cay, Uu, Ias, Ur, Uh, Uh, Xu, Uu, Ias, Uu, Uu, Xu, Xu, Xu, Xoa, Xoa, Urb, Urb, Wwg, Wwg, Wog, Wog, Wwrg, Xu
Xu, Xu, Qxu, Qxu, Qxu, Uu, Uu, Uu, Ur, Ur, Uu, Uu, Tb^Tf, Uu, Uu, Ias, Ias, Uu, Cay, Uu, Ias, Ias, Co, Uh, Xu, Uu, Ias, Ias, Uu, Xoa, Xoa, Xoa, Urb, Urb, Wwg, Wwg, Wwg, Wwg, Wog, Wog, Wog, Xu
Xu, Xu, Xu, Qxu, Uu, Uu, Ias, Ias, Ias, Uu, Uu, Tb^Tf, Uh, Tb^Tf, Uu, Uu, Uu, Ur, Ur, Ur, Co, Co, 2 Ko, Xu, Xoa, Uu, Ias, Ias, Ias, Uu, Ias, Rr^Pr\o, Xoa, Uu, Uu, Wwg, Wwg, Wog, Wog, Wog, Wog, Wog
Xu, Xu, Uu, Uu, Uu, Uu, Ur, Ias, Ias, Uu, Ds, Ds, Ds, Uh, Uh, Uu, Uu, Uu, Cay, Ur, Ias, Co, Co, Xoa^Efs, Ias, Ias, Uu, Ias, Ias, Ias, Ias, Ias, Xu, Uu, Xu, Uu, Uu, Wwg, Uu, Wwrg, Xu, Wog
Xu, Xu, Cay, Uu, Ur, Ur, Ias, Ur, Uu, Uu, Ds, Ds^Ecf, Ds, Uh, Uh, Uh, Uu, Uu, Cay, Ias, Ias, Ias, Uu^Edb, Ias, Ias, Ias, Ias, Ur, Ur, Uu, Xoa, Xu, Xu, Xu, Xu, Xu, Xu, Uu, Uu, Xu, Xu, Wog
Xu, Xu, Uu, Cay, Cay, Ur, Ias, Ias, Uu^Es, Uu, Uu, Ds, Uu, Uu^Vu, Uu, Uu, Uu, Uu, Cay, Ias, Uu^Edb, Uu^Edb, Uu^Edb, Uu, Uu, Uu, Ur, Ur, Ur, Ur, Rr^Pr/, Xoa, Xoa, Xu, Xu, Xu, Xu, Xu, Xu, Xu, Xu, Xu
Xu, Xu, Tb^Tf, Uu, Uu, Cay, Ur, Ur, Ias, Uu, Uu, Uu, Uu, Uu, Uu, Uu, Xu, Xu, Xu, Uu, Uu, Uu^Edb, Uu, Uu, Uu, Uu, Uu, Uu, Xoa, Ias^Pr/o, Ias, Wwg, Wwg, Xoa, Uu, Xu, Xoa, Xu, Xu, Xu, Xu, Xu
Xu, Xu, Tb^Tf, Tb^Tf, Uu, Uu, Uu, Ur, Ur, Cay, Cay, Cay, Cay, Uu, Uu, Uu, Xu, Xu, Xu, Xu, Xu, Uu, Tb^Tf, Uu, Xoa, Uu^Vu, Xoa, Xoa, Xu, Xoa, Xoa, Ias, Wwg, Wwg, Wwg, Uu, Uu, Xoa, Xoa, Xu, Xu, Xu
Xu, Xu, Xu, Tb^Tf, Tb^Tf, Uu, Uu, Ias, Ias, Uu, Uu, Cay, Uu, Cay, Cay, Uu, Xu, Xu, Xu, Xu, Xu, Xu, Xu, Xu, Xu, Xoa, Xu, Xu, Xu, Xu, Xoa, Uu, Wwg, Wwg, Wog, Wwg, Wwg, Wwrg, Wwrg, Xu, Xu, Xu
Xu, Xu, Xu, Tb^Tf, Tb, Uu, Uu, Ias, Ias, Uu, Uu, Uu, Uu, Uu, Uu, Xu, Xu, Xu, Xu, Xu, Xu, Xu, Xu, Xu, Xu, Xu, Xu, Xu, Xu, Xoa, Uu, Uu, Urb, Wwg, Wog, Wog, Wog, Wog, Xoa, Wog, Wog, Wog
Xu, Xu, Xu, Tb^Tf, Uh, Uu, Uu, Ias, Ur, Uu, Uu, Uu, Uu, Uu, Uu, Xu, Xu, Xu, Xu, Xu, Xu, Xu, Xu, Xu, Xu, Xu, Xu, Xu, Xu, Uu, Uu, Uu, Urb, Wwg, Wwg, Wwg, Wwg, Wog, Xoa, Wog, Xu, Xu
Xu, Xu, Xu, Xu, Uh, Uu, Uu, Ur, Ur, Rb, Uu, Uu, Uh, Uu, Xu, Xu, Xu, Xu, Xu, Xu, Xu, Xu, Xu, Xu, Xu, Xu, Xu, Xu, Xu, Xoa, Uu, Uu, Uu, Urb, Wog, Wwg, Wog, Wog, Xu, Xu, Xu, Xu
Xu, Xu, Xu, Xu, Uh, Uh, Uu, Uu, Uu, Rb, Uu, Uu, Uh, Uh, Xu, Xu, Xu, Xu, Xu, Xu, Xu, Xu, Xu, Xu, Xu, Xu, Xu, Xu, Xu, Xu, Xu, Uu, Xu, Uu, Xu, Wog, Wwrg, Wog, Xu, Xu, Xu, Xu
Xu, Xu, Xu, Xu, Xu, Uh, Uh, Uu, Uu, Rb, Rb, Uu, Uu, Uh, Xu, Xu, Xu, Xu, Xu, Xu, Xu, Xu, Xu, Xu, Xu, Xu, Xu, Xu, Xu, Xu, Xu, Xu, Xu, Xu, Xu, Xu, Xu, Xu, Xu, Xu, Xu, Xu
Xu, Xu, Xu, Xu, Xu, Uh, Uh, Uu, Uu, Rb, Rb, Uu, Xoa, Xu, Xoa, Xu, Xu, Xu, Xu, Xu, Xu, Xu, Xu, Xu, Xu, Xu, Xu, Xu, Xu, Xu, Xu, Xu, Xu, Xu, Xu, Xu, Xu, Xu, Xu, Xu, Xu, Xu
Xu, Xu, Xu, Xu, Xu, Xu, Xu, Xu, Uu, Rb, Rb, Uu, Uu, Xoa, Uu, Uu, Uu, Uu^Vu, Xu, Xu, Xu, Xu, Xu, Xu, Xu, Xu, Uu, Xu, Xu, Xu, Xu, Xu, Xu, Xu, Xu, Xu, Xu, Xu, Xu, Xu, Xu, Xu
Xu, Xu, Xu, Xu, Xu, Xu, Qxu, Qxu, Uu, Rb, Rb, Uu, Uu, Cay, Uu, Uu, Uu, Uu^Vu, Xu, Xu, Xu, Xu, Xu, Xu, Uu, Uh, Uh, Uh, Uu, Uu, Tb^Tf, Xu, Xu, Xu, Xu, Xu, Xu, Xu, Xu, Xu, Xu, Xu
Xu, Xu, Xu, Xu, Xu, Xu, Uh, Qxu, Uu, Uu^Edb, Ur, Uu^Edb, Urb^Edb, Urb, Urb, Urb, Uu, Uu^Vu, Xu, Xu, Xu, Xu, Xu, Xu, Uu, Uu, Uu, Uu, Uu, Uu, Uu, Tb^Tf, Tb^Tf, Xu, Xu, Xu, Xu, Xu, Xu, Xu, Xu, Xu
Xu, Xu, Xu, Xu, Xu, Uh, Uh, Uh, Uu, Uu, Ur, Ur, Uu^Edb, Uu^Edb, Uu, Uu, Uu, Uu, Xu, Xu, Xu, Xu, Uu, Uu, Uu, Uu, Uu, Ce, Ce, Ce, Uu, Uu, Tb^Tf, Tb^Tf, Tb^Tf, Xu, Xu, Xu, Xu, Xu, Xu, Xu
Xu, Xu, Xu, Xu, Xu, Uh, Uh, Uu, Uu, Urb, Uu, Uu^Edb, Uu, Cay, Xoa, Uu, Xu, Xu, Xu, Xu, Xu, Xu, Uu, Uu, Uu, Uu, Uu, Ce, Ce, Ce, Uu, Uu, Tb^Tf, Tb^Tf, Uu, Tb^Tf, Xu, Xu, Xu, Xu, Xu, Xu
Xu, Xu, Xu, Xu, Xu, Uh, Uu, Uu, Uu, Urb, Uu, Uu, Uu, Uu, Uu, Xoa, Xu, Xu, Xu, Xu, Tb^Tf, Uu, Uu, Uu, Uu, Uu, Uu, Uu, Ce, Uu, Uu, Uu, Uu, Uu, Uu, Uu, Uu, Xu, Re, Re, Re, Xu
Xu, Xu, Xu, Xu, Xu, Uu^Vu, Uu, Uu, Uu, Ur, Uu, Uu, Uu, Uu, Xu, Xu, Xu, Xu, Tb^Tf, Tb^Tf, Tb^Tf, Tb^Tf, Uu, Uu, Uu, Uu, Re, Re, Re, Rb, Re, Re, Rb, Rb, Re, Re, Rb, Rb, Re, Re, Re, Re
Xu, Xu, Xu, Xu, Xu, Xu, Cay, Cay, Cay, Ur, Cay, Cay, Cay, Xu, Xu, Xu, Xu, Uu, Uu, Tb^Tf, Uu, Uu, Uu, Uu, Re, Re, Re, Re, Re, Re, Re, Re, Uu, Rb, Uu, Rb, Uu, Rb, Uu, Re, Re, Re
Xu, Xu, Xu, Xu, Xu, Xu, Uu, Uu, Urb, Urb, Uu, Uu, Xu, Xu, Xu, Xu, Uu, Uu, Uu, Uu, Uu, Uu, Uu, Uu, Rb, Rb, Rb, Re, Uh, Uh, Uu, Uu, Uu, Uu, Xu, Uu, Xu, Uu, Uu, Uu, Uu, Xu
Xu, Xu, Xu, Xu, Xu, Uu, Uu, Uu, Urb, Uu, Uu, Uu, Xu, Xu, Xu, Xu, Uu, Uu, Rb, Rb, Rb, Re, Re, Re, Re, Rb, Uu, Uu, Uh, Uh, Tb^Tf, Tb^Tf, Xu, Xu, Xu, Xu, Xu, Xu, Xu, Xu, Xu, Xu
Xu, Xu, Xu, Xu, Xu, Uu, Uu, Uu, Ur, Uu, Uu, Uu, Xu, Xu, Xu, Xu, Uu, Uu, Uu, Rb, Re, Re, Ce, Uu, Uu, Uu, Uu, Uu, Uu, Tb^Tf, Xu, Xu, Xu, Xu, Xu, Xu, Xu, Xu, Xu, Xu, Xu, Xu
Xu, Xu, Xu, Xu, Xu, Uu^Edb, Uu^Edb, Uu^Edb, Urb^Edb, Uu, Uu, Uu, Uu^Vu, Xu, Uu, Uu, Ur, Uu, Ur, Rb, Rb, Ce, 1 Ke, Ce, Uu, Uu, Tb^Tf, Uu, Uu, Tb^Tf, Xu, Xu, Xu, Xu, Xu, Xu, Xu, Xu, Xu, Xu, Xu, Xu
Xu, Xu, Xu, Xu, Xu, Uu, Uu^Edb, Uu^Edb, Urb, Urb, Ur, Uu, Ur, Uh, Ur, Ur, Ur, Ur, Uu, Ur, Ur, Ce, Ce, Ce, Rb, Ur, Ur, Uu, Uu, Uu, Tb^Tf, Xu, Uu, Xu, Xu, Xu, Xu, Xu, Xu, Xu, Xu, Xu
Xu, Xu, Xu, Xu, Xu, Uu, Tb^Tf, Uu, Uu, Urb, Uu, Ur, Uu, Ur, Uu, Uu, Xu, Uu, Uu, Uu, Uu, Uu, Uu, Rb, Uu, Ur, Rb, Rb, Ur, Uu, Uu, Uu, Uu, Uu, Uu, Uu^Vu, Xu, Xu, Xu, Xu, Xu, Xu
Xu, Xu, Xu, Xu, Xu, Xu, Tb^Tf, Uu, Uu, Uu, Uu, Uu, Xu, Uu, Xu, Xu, Xu, Xu, Xu, Uu, Xu, Uu, Xu, Uu, Uu, Uu, Uu, Ur, Ur, Tb^Tf, Uu, Tb^Tf, Uu, Uu, Uu, Uu, Uu, Xu, Xu, Xu, Xu, Xu
Xu, Xu, Xu, Xu, Xu, Xu, Xu, Tb^Tf, Tb^Tf, Uu, Xu, Xu, Xu, Xu, Xu, Xu, Xu, Xu, Xu, Xu, Xu, Xu, Xu, Xu, Xu, Uu, Uu, Uu, Uu, Ur, Ur, Uu, Uu, Uu, Uu, Uh, Uu, Uu^Vu, Xu, Xu, Xu, Xu
Xu, Xu, Xu, Xu, Xu, Xu, Xu, Xu, Xu, Tb^Tf, Xu, Xu, Xu, Xu, Xu, Xu, Xu, Xu, Xu, Xu, Xu, Xu, Xu, Xu, Xu, Xu, Xu, Uu, Uu, Ur, Rb, Rb, Uu, Tb^Tf, Uu, Uu, Uu^Vu, Xu, Xu, Xu, Xu, Xu
Xu, Xu, Xu, Xu, Xu, Xu, Xu, Xu, Xu, Xu, Xu, Xu, Xu, Xu, Xu, Xu, Xu, Xu, Xu, Xu, Xu, Xu, Xu, Xu, Xu, Xu, Xu, Uu, Uu, Uu, Urb, Rb, Uu, Tb^Tf, Uu, Uu, Xu, Xu, Xu, Xu, Xu, Xu
