Ms^Xm, Ms^Xm, Ms^Xm, Ms^Xm, Ms^Xm, Ms, Ms, Ms, Ms^Xm, Ms^Xm, Ms, Ms, Ms, Ms, Ms^Xm, Ms, Ms, Ms, Ms, Xuc, Xu, Xu, Uu, Uu, Uu, Xu, Xu, Ms^Xm, Ms^Xm, Ms^Xm, Ms^Xm, Ms^Xm, Ms^Xm, Ms^Xm, Ms^Xm, Ms^Xm, Ms^Xm, Ms^Xm, Ms^Xm, Ms^Xm, Ms^Xm, Ms^Xm
Ms^Xm, Ms^Xm, Ms, Ms, Ms, Ms^Xm, Ms, Ms, Ms, Ms^Xm, Ms, Ms, Ms, Ms, Ms, Ms^Xm, Ms, Ms, Ms, Xue, Xue, Xuc, Uu, Uu, Uh, Xuc, Xuc, Ms^Xm, Ms^Xm, Ms^Xm, Ms^Xm, Ms^Xm, Ms^Xm, Ms^Xm, Ms^Xm, Ms^Xm, Ms^Xm, Ms^Xm, Ms^Xm, Ms^Xm, Ms^Xm, Ms^Xm
Ms^Xm, Ms, Ms, Ms, Ms, Ms, Ms, Ms, Ms, Ms, Ha, Ha, Ha, Ms, Ha, Ms, Ha, Ms, Ha, Ha^Fpa, Ha^Fpa, Xue, Rb, Rb, Rb, Uh, Xue, Xue, Ha^Fpa, Ha, Ha, Ms^Xm, Ha, Ms^Xm, Ms^Xm, Ms^Xm, Ms^Xm, Ms^Xm, Ms^Xm, Ms^Xm, Ms^Xm, Ms^Xm
Ms^Xm, Ms, Ms, Ms, Ms, Ms, Ms, Ms, Ha, Ha, Ha, Ha, Ha, Ha, Ha, Ha, Ha, Ha, Ha, Ha^Fpa, Ha, Ha, Rb, Rb, 1 Rb, Rb, Ha^Fpa, Ha^Fpa, Ha^Fpa, Ha, Ha, Ha, Ha, Ha, Ha, Ms^Xm, Ms, Ms, Ms, Ms^Xm, Ms^Xm, Ms^Xm
Ms^Xm, Ms, Ms, Ms, Ms, Ms, Ha, Ha, Ha, Ha, Ha^Fpa, Ha, Aa, Ha, Ha, Ha, Ha, Ms, Ha, Ha, Ha, Ha, Ha, Rb, Rb, Rb, Rb, Ha, Ha, Ha, Ha, Ms, Ha, Ha, Ha, Ha, Ms, Ms, Ms, Ms^Xm, Ms^Xm, Ms^Xm
Ms^Xm, Ms, Ms, Ms, Ha, Ha, Ha, Ha, Ha, Ha, Aa, Aa, Aa, Ha, Ha, Ha, Ha, Ha, Ha, Ha, Ha, Ha, Ha, Rb, Rb, Rb, Rb, Rb, Aa, Ha, Ha, Ha, Ha, Ha, Ha, Ha, Ha, Ms, Ms^Xm, Ms^Xm, Ms^Xm, Ms^Xm
Ms^Xm, Ms, Ha, Ha, Ha, Ha, Ha, Ha, Aa, Aa, Aa, Aa, Aa, Aa, Aa, Ha, Ha, Ha, Ha^Voa, Ha, Aa, Ha, Aa, Ha, Rb, Rb, Rb, Rb, Aa, Aa, Aa^Fpa, Ha, Ha, Ha, Ms, Ha, Ha, Ha, Ms^Xm, Ms^Xm, Ms^Xm, Ms^Xm
Ms^Xm, Ms, Ha, Ms, Ha, Ha, Aa^Fpa, Aa, Aa^Esa, Aa, Aa, Aa^Fpa, Aa, Aa, Aa, Aa, Aa, Aa, Aa, Aa, Aa, Aa, Aa, Aa, Rb^Esa, Rb, Rb, Rb, Aa, Aa, Aa^Fpa, Aa^Fpa, Ha, Ha, Ha, Ha, Ha, Ha, Ms, Ms^Xm, Ms^Xm, Ms^Xm
Ms, Ms, Ha, Ha, Ha, Ha, Aa^Fpa, Aa, Aa, Aa, Aa, Aa, Aa, Aa, Aa, Aa, Aa, Aa, Aa, Aa, Aa^Esa, Aa, Aa, Aa, Rb, Rb, Rb, Aa, Aa, Aa, Aa, Aa^Fpa, Aa^Fpa, Ha, Ha, Ha, Ha, Ha, Ms, Ms^Xm, Ms^Xm, Ms^Xm
Ms, Ms, Ms, Ha, Ha, Ha, Aa^Fpa, Aa, Aa, Aa, Aa^Voa, Aa, Aa, Aa, Aa^Fpa, Aa, Aa, Aa, Aa, Aa, Aa, Aa, Aa^Fpa, Aa^Fpa, Rb, Rb, Rb, Aa, Aa, Aa, Aa, Aa, Aa, Aa^Fpa, Aa^Fpa, Ha, Ha, Ha, Ms, Ms, Ms^Xm, Ms^Xm
Ms, Ms, Ms, Ha, Ha, Ha, Ha, Aa^Fpa, Aa, Aa, Aa, Aa, Aa, Aa, Aa, Aa, Aa, Aa, Aa, Aa, Aa, Aa, Aa^Fpa, Aa^Fpa, Rb, Rb, Rb, Rb^Esa, Aa, Aa, Aa, Aa, Aa, Aa, Aa, Aa^Fpa, Ha, Ha, Ms, Ms, Ms^Xm, Ms^Xm
Ms, Ms, Ms, Ha, Ms, Ha, Ha, Aa^Fpa, Aa^Fpa, Aa, Aa, Aa, Aa, Aa, Aa, Aa, Aa, Aa^Esa, Aa, Aa, Aa, Aa, Aa^Fpa, Aa^Fpa, Aa^Fpa, Rb, Rb, Rb, Aa, Aa, Aa, Aa, Aa^Esa, Aa, Aa^Fpa, Ha^Voa, Ha, Ha, Ms, Ms^Xm, Ms^Xm, Ms^Xm
Ms, Ms, Ms, Ha, Ha, Ha, Ha, Ha, Ha, Aa^Fpa, Aa^Fpa, Aa, Aa^Fpa, Aa, Aa, Aa, Aa, Aa, Aa, Aa, Aa, Aa, Aa, Aa^Fpa, Rb, Rb, Rb, Rb, Aa, Aa, Aa, Aa, Aa, Aa, Aa^Fpa, Ha, Ha, Ha, Ms, Ms^Xm, Ms^Xm, Ms^Xm
Ms, Ms, Ms, Ms, Ms, Ha, Ha, Ha, Ha, Aa^Fpa, Aa^Fpa, Aa^Fpa, Aa^Fpa, Aa, Aa, Aa, Aa, Aa, Aa, Aa, Aa^Fpa, Aa, Aa, Aa, Rb, Rb, Rb, Rb, Aa, Aa, Aa, Aa, Aa, Aa, Aa^Fpa, Ha, Ha, Ha, Ms, Ms^Xm, Ms^Xm, Ms^Xm
Ms, Ms, Ms, Ms, Ms, Ha, Ha, Ha, Ha, Aa^Fpa, Aa, Aa, Aa, Aa, Aa, Aa, Aa, Aa, Aa, Aa^Voa, Aa, Aa, Aa, Cea, Cer, Rb, Rb, Rb^Esa, Aa, Aa, Aa, Aa, Aa, Aa^Fpa, Aa^Fpa, Ha, Ha, Ha, Ha, Ms^Xm, Ms^Xm, Ms^Xm
Ms, Ms, Ms, Ms, Ha, Ha, Ha, Ha, Aa^Fpa, Aa^Fpa, Aa, Aa, Aa, Aa, Aa, Aa, Aa, Aa, Aa, Aa, Aa, Aa, Cea, Ket, Rb, Rb, Rb, Rb, Aa, Aa, Aa, Aa, Aa, Aa^Fpa, Aa^Fpa, Ha, Ha, Ha, Ms, Ms, Ms^Xm, Ms^Xm
Ms, Ms, Ms, Ms, Ha, Ha, Ha, Aa^Fpa, Aa^Fpa, Aa^Vha, Aa, Aa, Aa^Esa, Aa, Aa^Fpa, Aa, Aa, Aa, Aa, Aa, Aa, Aa, Rb, Rb, Rb^Esa, Rb, Rb, Rb, Aa, Aa, Aa, Aa, Aa, Aa^Fpa, Aa^Fpa, Ha, Ha, Ha, Ms, Ms, Ms^Xm, Ms^Xm
Ms, Ms, Ms, Ms, Ha, Ha, Ha, Ha, Aa^Fpa, Aa, Aa, Aa, Aa, Aa, Aa, Aa, Aa, Aa^Fpa, Aa^Fpa, Aa, Rb^Esa, Rb, Rb, Rb, Rb, Rb, Aa^Fpa, Aa^Fpa, Aa, Aa, Aa, Aa, Aa^Fpa, Aa^Fpa, Aa^Fpa, Ha, Ha, Ha, Ms, Ms^Xm, Ms^Xm, Ms^Xm
Ms, Ms, Ms, Ms, Ha, Ha, Ha^Fpa, Ha, Aa^Fpa, Aa, Aa, Aa, Aa, Aa, Aa, Aa, Aa^Fpa, Aa^Fpa, Aa^Fpa, Aa^Fpa, Rb, Rb, Rb, Rb, Aa^Fpa, Aa^Fpa, Aa^Fpa, Aa^Fpa, Aa, Aa, Aa^Fpa, Aa, Aa^Fpa, Aa^Fpa, Aa^Fpa, Aa^Fpa, Ha, Ha, Ms, Ms^Xm, Ms^Xm, Ms^Xm
Ms, Ms, Ms, Ms, Ha, Ha, Ha, Ha, Aa^Fpa, Aa, Aa, Aa, Aa, Aa, Aa, Aa, Aa^Fpa, Aa^Fpa, Aa^Fpa, Rb, Rb, Rb, Aa^Fpa, Rb, Aa^Fpa, Aa^Fpa, Aa, Aa, Aa, Aa, Aa, Aa, Aa, Aa^Fpa, Aa^Fpa, Aa^Fpa, Ha, Ha, Ha, Ms^Xm, Ms^Xm, Ms^Xm
Ms, Ms, Ms, Ms, Ha, Ha, Ha, Ha, Ha, Aa^Fpa, Aa, Aa, Aa, Aa, Aa, Aa^Fpa, Aa^Fpa, Aa^Fpa, Rb, Rb, Rb, Aa^Fpa, Aa^Fpa, Aa^Fpa, Aa, Aa, Aa^Fpa, Aa^Fpa, Aa^Fpa, Aa, Aa, Aa, Aa, Aa^Fpa, Aa, Aa^Fpa, Ha, Ha, Ha, Ms^Xm, Ms^Xm, Ms^Xm
Ms, Ms, Ms, Ha, Ha, Ha, Ha, Ha, Ha^Voa, Aa^Fpa, Aa^Fpa, Aa^Esa, Aa, Aa, Aa, Aa, Aa^Fpa, Aa^Fpa, Rb, Rb, Rb, Aa^Fpa, Gs^Fp, Aa, Aa, Aa, Gd, Gs^Fp, Gd, Aa, Aa^Esa, Aa, Aa, Aa, Aa, Ha^Voa, Ha, Ha, Ha, Ms^Xm, Ms^Xm, Ms^Xm
Ms, Ms, Ms, Ha, Ha, Ms, Ha, Ha, Ha, Aa^Fpa, Aa^Fpa, Aa, Aa, Aa, Aa, Coa, Koa, Rb, Rb, Rb, Rb, Gs^Fp, Gs^Fp, Aa, Gs^Fp, Gs^Fp, Gs^Fp, Gd, Gd, Aa, Aa, Aa, Aa, Aa, Aa, Ha, Ha, Ha, Ha, Ms^Xm, Ms^Xm, Ms^Xm
Aa^Fpa, Aa^Fpa, Aa^Fpa, Ha, Ha, Ha, Aa^Fpa, Ha, Ha, Aa^Fpa, Aa, Aa, Aa^Esa, Aa, Aa, Coa, Coa, Co, Re^Vct, Re^Vct, Co, Gg^Vo, Gs^Fp, Gs^Fp, Uu, Uu, Uu, Gs^Fp, Gs^Fp, Gd, Gs^Fp, Aa^Fpa, Aa^Fpa, Aa, Aa, Ha, Ha, Ha, Ha, Ms^Xm, Ms^Xm, Ms^Xm
Aa^Fpa, Aa^Fpa, Aa^Fpa, Ha, Ha, Ha^Fpa, Ha^Fpa, Ha, Aa^Fpa, Aa^Fpa, Aa, Aa, Aa, Aa, Aa, Aa, Aa^Fpa, Rb, Re^Vct, Co, 3 Ko, Cer, Gd, Uu, Uh, Uh, Uh, Uu, Gs^Fp, Gd, Gd, Aa^Fpa, Aa, Aa, Aa, Aa, Ha, Ha, Ha, Ha, Ms^Xm, Ms^Xm
Aa^Fpa, Aa^Fpa, Ha, Ha, Ha, Ha^Fpa, Aa^Fpa, Aa^Fpa, Aa, Aa, Aa, Aa, Aa, Aa, Aa, Aa^Fpa, Aa^Fpa, Rb, Rb, Cer, Co, Co, Gs^Fp, Uu, Uh, Ql, Uh, Uu, Gs^Fp, Gs^Fp, Gs^Fp, Aa, Aa, Aa, Aa, Aa, Ha, Ha, Ha, Ms, Ms^Xm, Ms^Xm
Aa^Fpa, Aa^Fpa, Aa^Fpa, Ha, Ha, Ha, Aa^Fpa, Aa^Fpa, Aa, Aa, Aa^Fpa, Aa, Aa, Aa^Voa, Aa, Aa^Fpa, Aa^Fpa, Aa^Fpa, Rb, Re, Re, Gd, Gs^Fp, Uu, Uu, Uh, Uu, Uu, Gg^Vo, Gs^Fp, Aa^Fpa, Aa, Aa, Aa, Aa, Aa, Aa, Ha, Ha, Ms, Ms, Ms^Xm
Aa^Fpa, Aa^Fpa, Aa^Fpa, Ha, Ha, Aa^Fpa, Aa^Fpa, Aa, Aa, Aa^Fpa, Aa^Fpa, Aa^Fpa, Aa, Aa, Aa, Aa^Fpa, Rb^Es, Rb^Es, Re^Es, Re, Rb^Es, Re, Gg^Vo, Gs^Fp, Uh, Ql, Uh, Gs^Fp, Gs^Fp, Gs^Fp, Aa^Fpa, Aa, Aa, Aa, Aa, Aa, Aa, Ha, Ha, Ha, Ha, Ms
Aa^Fpa, Aa^Fpa, Aa^Fpa, Ha, Aa, Aa, Aa, Aa, Aa, Aa^Fpa, Aa, Aa, Aa, Aa, Rb, Rb, Rb, Re^Es, Re, Rb^Es, Ww, Rb, Rb, Gs^Fp, Uu, Uh, Uu, Gs^Fp, Aa^Fpa, Aa^Fpa, Aa^Fpa, Aa, Aa, Aa^Fpa, Aa, Aa, Aa, Ha, Ha, Ha, Ms, Ha
Aa^Fpa, Aa^Fpa, Aa^Fpa, Aa^Fpa, Aa, Aa, Aa^Fpa, Aa, Aa, Aa, Aa, Aa, Rb, Rb, Rb, Rb, Aa^Fpa, Re, Gs^Fp, Ww, Ww, Rb, Rb, Gs^Fp, Uh, Uh, Uu, Gs^Fp, Gs^Fp, Aa^Fpa, Aa, Aa, Aa, Aa, Aa, Aa, Aa^Fpa, Aa^Fpa, Ha, Ha, Ha, Ha
Aa^Fpa, Aa^Fpa, Aa^Fpa, Aa^Fpa, Aa, Aa, Aa, Aa, Aa, Aa, Rb, Rb^Esa, Rb, Rb, Aa^Fpa, Aa^Fpa, Aa^Fpa, Aa^Fpa, Aa^Fpa, Gs^Fp, Ww, Rb, Re^Es, Rb^Es, Uu, Ql, Uu, Gs^Fp, Aa, Aa^Fpa, Aa, Aa, Aa, Aa, Aa, Aa^Fpa, Aa^Fpa, Ha, Ha^Voa, Ha, Ha, Ha
Aa^Fpa, Aa^Fpa, Aa^Fpa, Aa^Fpa, Aa^Fpa, Aa, Aa, Aa^Esa, Rb, Rb, Rb, Rb, Aa^Fpa, Rb, Aa^Fpa, Aa^Fpa, Aa^Fpa, Aa^Fpa, Aa^Fpa, Ai, Ai, Re, Re, Rb^Es, Rb^Es, Uu, Gs^Fp, Gs^Fp, Aa, Aa, Aa, Aa, Aa^Fpa, Aa, Aa, Aa^Fpa, Aa^Fpa, Aa^Fpa, Aa^Fpa, Ha, Ha, Aa^Fpa
Aa^Fpa, Aa^Fpa, Aa^Fpa, Aa^Fpa, Aa^Fpa, Aa, Aa, Aa, Rb, Rb, Rb, Aa^Fpa, Aa^Fpa, Aa^Fpa, Aa^Fpa, Aa^Fpa, Aa^Fpa, Aa^Fpa, Aa^Fpa, Aa^Fpa, Aa^Fpa, Rb, Rb, Re^Es, Rb, Aa, Aa, Aa, Aa, Aa, Ha, Aa, Aa, Aa, Aa, Aa, Aa, Aa^Fpa, Aa^Fpa, Ha, Ha, Aa^Fpa
Aa^Fpa, Aa^Fpa, Aa^Fpa, Aa^Fpa, Aa, Aa, Aa, Aa, Rb^Esa, Rb, Aa^Fpa, Aa^Fpa, Aa^Fpa, Aa^Fpa, Aa^Fpa, Aa^Fpa, Aa, Aa^Fpa, Aa, Aa^Fpa, Aa^Fpa, Aa^Fpa, Aa^Fpa, Rb, Rb, Rb, Aa, Aa^Voa, Aa, Aa, Ha^Fpa, Ha, Aa, Aa, Aa, Aa, Aa, Aa, Aa, Aa^Fpa, Aa^Fpa, Aa^Fpa
Aa^Fpa, Aa^Fpa, Aa^Fpa, Aa^Fpa, Aa, Aa, Rb, Rb, Rb, Rb, Aa^Fpa, Aa^Fpa, Aa^Fpa, Aa^Fpa, Aa, Aa, Aa, Aa, Aa, Aa^Fpa, Aa^Fpa, Aa^Fpa, Aa^Fpa, Aa^Fpa, Rb, Rb, Rb^Esa, Aa, Aa, Aa^Fpa, Ha, Ha, Aa^Fpa, Aa^Fpa, Aa^Fpa, Aa^Fpa, Aa, Aa, Aa, Aa^Fpa, Aa^Fpa, Aa^Fpa
Aa^Fpa, Aa^Fpa, Aa, Aa, Aa, Rb^Esa, Re, Re, Rb, Rb, Aa, Aa^Fpa, Aa, Aa, Ai^Esa, Aa^Esa, Ai^Esa, Aa, Aa^Voa, Aa, Aa, Aa^Fpa, Aa^Fpa, Aa^Fpa, Rb, Rb, Rb, Aa, Aa, Aa, Ha, Ha^Fpa, Aa^Fpa, Aa^Fpa, Aa^Fpa, Aa^Fpa, Aa^Fpa, Aa, Aa, Aa^Fpa, Aa^Fpa, Aa^Fpa
Aa^Fpa, Aa^Fpa, Aa, Aa, Rb, Rb, Re, Rb, Aa, Aa, Ha, Aa, Aa^Voa, Ai, Ai, Ai, Ww, Ai, Ai, Aa, Aa, Aa^Fpa, Aa^Fpa, Aa^Fpa, Rb, Re, Re, Rb, Aa, Aa^Fpa, Aa^Fpa, Ha, Aa^Fpa, Aa^Fpa, Aa^Fpa, Aa^Fpa, Aa^Fpa, Aa, Aa, Aa^Fpa, Aa^Fpa, Aa^Fpa
Ha, Ha, Aa, Aa, Rb, Re^Es, Re^Es, Rb, Aa, Ha, Ha, Ha, Aa, Ai, Ai, Ai, Ai, Ai, Ai, Ww, Aa, Aa, Aa^Fpa, Aa^Fpa, Aa^Fpa, Rb, Re, Rb, Aa, Aa, Aa, Aa^Fpa, Aa^Fpa, Aa^Fpa, Aa^Fpa, Aa^Fpa, Aa^Fpa, Aa, Aa, Aa^Fpa, Aa^Fpa, Aa^Fpa
Ha^Fpa, Ha, Aa^Fpa, Aa, Rb, Re^Es, Rb, Rb, Aa, Ha, Ha^Fpa, Ha, Ha, Aa, Ha, Ai, Ai, Ai, Ai, Ai, Ha, Aa, Aa^Fpa, Aa^Fpa, Aa^Fpa, Rb, Rb, Rb, Aa, Aa, Aa, Aa, Aa, Aa^Voa, Aa, Aa^Fpa, Aa^Fpa, Aa, Aa, Aa^Fpa, Aa^Fpa, Aa^Fpa
Ha^Fpa, Ha^Fpa, Aa^Fpa, Aa, Rb, Rb^Es, Rb, Aa, Aa^Fpa, Ha^Fpa, Ha^Fpa, Ha, Ha, Ha, Ha, Ha, Ha^Esa, Ai, Ha, Ha, Ha, Ha, Aa, Aa^Fpa, Aa^Fpa, Rb, Rb, Rb, Aa, Aa, Aa^Fpa, Aa, Aa, Aa, Aa, Aa, Aa, Aa, Aa, Aa, Aa^Fpa, Aa^Fpa
Ha, Ha, Aa, Aa, Rb, Rb, Rb, Rb, Rb, Aa^Fpa, Aa, Ha, Aa, Ha, Ha^Fpa, Ha^Fpa, Ha, Ha, Ha^Esa, Ha, Ha, Ha, Aa, Aa^Fpa, Aa^Fpa, Aa^Fpa, Rb^Esa, Rb, Rb, Aa^Fpa, Aa^Fpa, Aa^Fpa, Aa, Aa, Aa^Esa, Aa, Aa, Aa, Aa, Aa, Aa, Aa^Fpa
Ha, Ha, Aa, Aa, Aa, Rb, Rb^Esa, Rb, Rb, Rb, Rb, Aa, Rb^Esa, Aa, Aa^Fpa, Ha^Fpa, Ha, Ha, Ha, Ha, Aa, Aa, Aa, Aa^Fpa, Aa^Fpa, Aa^Fpa, Rb, Rb, Rb, Aa^Fpa, Aa^Fpa, Aa^Fpa, Aa, Aa, Aa, Aa, Aa, Aa, Aa, Aa, Aa, Aa^Fpa
Ha, Aa, Aa, Aa^Fpa, Aa, Aa, Aa, Rb, Rb^Esa, Rb, Rb^Es, Rb^Es, Re^Es, Rb, Rb, Aa, Aa, Ha, Ha^Vhha, Aa, Aa, Aa, Aa, Aa, Aa^Fpa, Aa^Fpa, Aa^Fpa, Rb, Rb, Rb, Aa^Fpa, Aa^Fpa, Aa^Fpa, Aa, Aa, Aa, Aa^Fpa, Aa^Fpa, Aa^Fpa, Aa, Aa, Aa
Aa^Fpa, Aa^Fpa, Aa^Fpa, Aa, Aa, Aa, Aa, Aa, Aa, Rb, Rb, Re^Es, Re^Es, Re, Rb, Aa, Aa, Aa, Aa, Aa, Aa, Aa, Aa, Aa, Aa^Fpa, Aa^Fpa, Aa^Fpa, Rb, Rb, Rb, Aa^Fpa, Aa^Fpa, Aa^Fpa, Aa, Aa, Aa, Aa, Aa^Fpa, Aa, Aa, Aa, Aa
Aa^Fpa, Aa^Fpa, Aa^Fpa, Aa, Aa, Aa^Fpa, Aa^Fpa, Aa, Ha, Ha, Ha, Rb, Rb, Re^Es, Rb, Rb, Aa^Fpa, Aa, Aa, Aa, Aa, Aa^Esa, Aa, Aa, Rb, Aa^Fpa, Rb^Esa, Rb, Rb, Rb, Aa^Fpa, Aa^Fpa, Aa^Vha, Aa, Aa, Aa^Fpa, Aa, Aa, Aa, Aa, Aa, Aa
Aa^Fpa, Aa^Fpa, Aa^Fpa, Aa, Aa, Aa, Aa^Fpa, Ha, Ha, Ha, Ha, Ha, Rb, Rb, Re, Rb, Rb, Aa^Fpa, Aa^Fpa, Aa, Aa^Fpa, Aa, Rb^Es, Rb, Rb, Rb, Rb, Rb, Rb, Aa^Fpa, Aa^Fpa, Aa^Fpa, Aa, Aa, Aa, Aa, Aa, Aa, Aa^Esa, Aa, Aa, Aa
Aa^Fpa, Aa^Fpa, Aa^Fpa, Aa, Aa, Aa^Fpa, Aa^Fpa, Ha, Ha, Ha, Ha, Ha, Ha, Rb, Rb, Rb, Rb, Aa^Fpa, Aa^Fpa, Aa^Fpa, Rb, Rb, Re^Es, Rb^Es, Rb, Rb, Rb, Rb, Aa^Esa, Aa^Fpa, Aa^Fpa, Aa^Fpa, Aa, Aa, Aa, Aa, Aa, Aa, Aa, Aa, Aa, Aa
Aa^Fpa, Aa^Fpa, Aa, Aa, Aa, Aa^Fpa, Aa^Fpa, Ha, Ha, Ha, Ha^Voa, Ha, Ha, Aa^Fpa, Rb, Rb, Rb, Aa^Fpa, Aa^Fpa, Rb, Cer, Rb, Rb, Rb, Aa, Rb, Aa^Fpa, Aa, Aa, Aa^Fpa, Aa^Fpa, Aa, Aa^Esa, Aa, Aa, Aa, Aa, Aa, Aa, Aa, Aa, Aa
Aa^Fpa, Aa^Fpa, Aa, Aa, Aa, Aa, Aa^Fpa, Aa^Fpa, Aa, Ha, Ha, Ha, Aa^Fpa, Aa^Fpa, Aa, Rb, Rb^Edb, Rb, Cer, Cer, Cer, Rb, Aa, Aa, Aa^Fpa, Aa^Fpa, Gs^Fp, Aa^Fpa, Gs^Fp, Aa, Aa^Fpa, Aa, Aa, Aa, Aa^Fpa, Aa, Aa, Aa, Aa, Aa, Aa, Aa
Aa^Fpa, Aa^Fpa, Aa, Aa, Aa, Aa, Aa, Aa, Aa, Aa, Aa, Aa^Fpa, Aa, Aa^Fpa, Aa, Rb^Esa, Rb, Cer, Cer, 2 Ke, Cer, Rb, Ai, Aa^Fpa, Re, Re, Uu, Re, Re, Aa^Fpa, Aa^Fpa, Aa^Fpa, Aa^Fpa, Aa^Fpa, Aa^Fpa, Aa^Fpa, Aa^Fpa, Aa^Fpa, Aa^Fpa, Aa, Aa, Aa
Aa^Fpa, Aa^Fpa, Aa, Aa^Esa, Aa, Aa, Aa, Aa, Aa, Aa, Aa, Aa, Aa, Aa, Aa^Esa, Aa, Aa, Rb, Rb, Cer, Rb^Edb, Ai, Ww, Gs^Fp, Gs^Fp, Uu, Ql, Uu, Re, Gs^Fp, Aa^Fpa, Aa^Fpa, Aa^Fpa, Aa^Fpa, Ha, Ha, Ha, Aa^Fpa, Aa^Fpa, Aa^Fpa, Aa, Aa
Aa^Fpa, Aa^Fpa, Aa, Aa, Aa, Aa, Aa^Fpa, Aa, Aa^Fpa, Aa^Fpa, Aa^Fpa, Aa, Aa, Aa, Aa, Aa, Aa^Fpa, Aa^Fpa, Rb, Rb^Edb, Rb^Edb, Rb, Ww, Gs^Fp, Re, Uu, Uu, Uu, Gs^Fp, Aa^Fpa, Aa^Fpa, Aa^Fpa, Aa^Fpa, Ha, Ha, Ha, Ha, Ha, Aa^Fpa, Aa^Fpa, Aa^Fpa, Aa
Aa^Fpa, Aa^Fpa, Aa, Aa, Aa^Fpa, Aa^Fpa, Aa^Fpa, Aa^Fpa, Aa^Fpa, Aa^Fpa, Aa^Fpa, Aa^Fpa, Aa^Fpa, Aa, Aa, Aa, Aa^Esa, Aa^Fpa, Rb, Rb^Edb, Rb^Edb, Rb, Ss, Ss, Gs^Fp, Gs^Fp, Gg^Vo, Re, Gs^Fp, Aa^Fpa, Aa^Fpa, Aa^Fpa, Aa^Fpa, Aa^Fpa, Ha^Voa, Ha, Ha, Ha, Ha, Aa^Fpa, Aa^Fpa, Aa
Ha, Aa^Fpa, Aa, Aa, Aa^Fpa, Aa^Fpa, Aa^Fpa, Aa^Fpa, Aa^Fpa, Aa^Fpa, Aa^Fpa, Aa^Fpa, Aa^Fpa, Aa^Fpa, Aa, Aa, Aa, Aa, Aa, Rb, Rb, Rb, Rb, Ss, Ww, Gs^Fp, Aa^Fpa, Gs^Fp, Aa^Fpa, Aa^Fpa, Aa, Aa, Aa, Aa^Fpa, Aa^Fpa, Ha, Ha, Ha, Ha, Ha, Aa^Fpa, Aa
Ha, Ha, Aa, Aa, Aa^Fpa, Aa^Fpa, Aa^Fpa, Aa^Fpa, Aa^Fpa, Aa^Fpa, Aa^Fpa, Aa^Fpa, Aa^Fpa, Aa^Fpa, Aa, Aa, Aa, Aa, Aa, Rb, Rb^Edb, Rb^Edb, Rb^Edb, Rb, Rb, Ww, Ai, Aa, Aa, Aa, Aa, Aa, Aa, Aa^Fpa, Aa^Fpa, Aa^Fpa, Aa^Fpa, Ha, Ha, Ha, Ha, Aa
Ha, Ha, Ha, Aa, Aa, Aa^Fpa, Aa^Fpa, Aa^Fpa, Aa^Fpa, Aa^Fpa, Aa^Fpa, Aa^Fpa, Aa^Fpa, Aa, Aa, Aa, Aa, Aa, Aa, Aa^Fpa, Aa^Fpa, Rb^Edb, Rb^Edb, Rb^Edb, Rb, Ai, Aa, Aa, Aa, Aa, Aa, Aa, Aa, Aa, Aa, Aa^Fpa, Aa, Aa^Fpa, Aa^Fpa, Aa^Fpa, Aa^Fpa, Aa
Ha^Fpa, Ha^Fpa, Ha, Ha, Aa^Fpa, Aa, Aa, Aa, Aa, Aa^Fpa, Aa, Aa^Fpa, Aa, Aa, Aa, Aa, Aa, Aa, Aa^Fpa, Aa^Fpa, Aa^Fpa, Aa^Fpa, Aa^Fpa, Rb, Rb, Rb, Rb, Rb, Rb, Aa, Aa, Aa^Esa, Aa, Aa, Aa, Aa, Aa, Aa^Fpa, Aa, Aa^Fpa, Aa, Aa
Ha, Ha, Ha, Ha^Fpa, Aa^Fpa, Aa^Fpa, Aa, Aa, Aa, Aa, Aa, Aa, Aa, Aa, Aa, Aa, Aa, Aa^Fpa, Aa^Fpa, Aa^Fpa, Aa^Fpa, Aa^Fpa, Aa, Rb, Rb, Rb, Rb, Rb, Rb, Rb^Esa, Aa, Aa, Aa, Aa, Aa, Aa, Aa, Aa, Aa, Aa, Aa, Aa
Ha^Fpa, Ha, Ha, Ha, Aa, Aa, Aa, Aa, Aa, Aa, Aa, Aa^Voa, Aa, Aa, Aa^Esa, Aa, Aa, Aa^Fpa, Aa, Aa^Fpa, Aa, Aa, Aa, Aa, Aa, Rb^Esa, Rb, Rb, Rb, Rb, Aa, Aa, Aa, Aa^Esa, Aa, Aa, Aa, Aa, Aa, Aa, Aa, Aa
Aa^Fpa, Ha^Fpa, Ha^Fpa, Ha^Fpa, Aa^Fpa, Aa, Aa, Aa^Esa, Aa, Aa, Aa, Aa, Aa, Aa, Aa, Aa, Aa, Aa, Aa, Aa, Aa, Aa, Aa, Aa, Rb, Rb, Rb, Rb, Rb, Aa, Aa, Aa, Aa, Aa, Aa, Aa, Aa^Fpa, Aa, Aa^Fpa, Aa, Aa, Aa
Aa^Fpa, Aa^Fpa, Aa^Fpa, Aa^Fpa, Aa, Aa, Aa, Aa, Aa, Aa, Aa^Fpa, Aa^Fpa, Aa^Fpa, Aa, Aa, Aa, Aa, Aa, Aa, Aa, Aa, Aa, Aa, Aa, Rb, Rb, Rb, Rb, Aa, Aa, Aa, Aa, Aa, Aa, Aa, Aa^Fpa, Aa^Fpa, Aa^Fpa, Aa^Fpa, Aa^Fpa, Aa^Fpa, Aa
Aa^Fpa, Aa^Fpa, Aa^Fpa, Aa^Fpa, Aa, Aa, Aa, Aa, Aa^Fpa, Aa^Fpa, Aa^Fpa, Aa^Fpa, Aa^Fpa, Aa^Fpa, Aa, Aa, Aa, Aa, Aa, Aa, Aa, Aa, Aa, Aa, Rb, Rb, Rb, Aa, Aa, Aa, Aa, Aa, Aa, Aa, Aa, Aa^Fpa, Aa^Fpa, Aa^Fpa, Aa^Fpa, Aa^Fpa, Aa^Fpa, Aa^Fpa
