Xos, Xos, Xos, Xos, Xos, Xos, Xos, Xos, Xos, Xos, Xos, Xos, Xos, Xos, Xos, Xos, Xos, Xos, Xos, Xos, Xos, Xos, Xos, Xos, Xos, Xos, Xos, Xos, Xos, Xos, Xos, Xos, Xos, Xos, Xos, Xos, Xos, Xos, Xos, Xos, Xos, Xos, Xos, Xos, Xos, Xos
Xos, Xos, Xos, Xos, Urb, Xos, Urb, Urb, Urb, Urb, Urb, Urb, Urb, Xos, Xos, Xos, Xos, Xos, Rrc, Xos, Xos, Xos, Rrc, Xos, Xos, Xos, Xos, Xos, Irs, Irs, Irs, Xos, Xos, Xos, Irs, Xos, Xos, Xos, Irs, Xos, Xos, Xos, Xos, Xos, Xos, Xos
Xos, Xos, Urb, Urb, Urb, Urb, Urb, Urb, Ai^Yfro, Urb, Ai^Yfro, Urb, Urb, Urb, Urb, Xos, Rrc, Rrc, Rrc, Rrc, Rrc, Rrc, Rrc, Rrc, Rrc, Rrc, Irs, Irs, Irs, Irs, Icr, Icr^Bryu, 2 Icr^Kov, Icr^Bryu, Icr, Irs, Irs, Irs, Irs^Ii, Irs, Irs, Rrc, Rrc^Taby, Xos, Xos, Xos
Xos, Xos, Urb, Urb^Esd, Urb, Urb, Ai^Yfro, Ai^Yfro, Ai^Yfro, Ai^Yfro, Ai^Yfro, Urb, Urb, Urb, Urb, Xos, Xos, Rrc, Rrc, Rrc, Rrc, Rrc, Xos, Rrc, Rrc, Irs, Irs, Irs, Irs, Icr, Icr, Icr^Cov, Icr, Icr^Cov, Icr, Icr, Irs, Irs, Irs, Irs, Rrc, Rrc, Rrc, Rrc, Rrc, Xos
Xos, Urb, Urb, Urb, Ai^Yfro, Ai^Yfro, Ai^Yfro, Ai^Yfro, Ai^Yfro, Ai^Yfro, Ai^Yfro, Ai^Yfro, Urb, Urb, Urb, Xos, Xos, Rrc, Rrc, Rrc, Rrc, Xos, Rrc, Rrc, Rrc^Esd, Rrc, Rrc, Irs, Irs, Irs, Irs, Icr, Icr, Icr, Irs, Irs, Irs, Irs, Rrc, Rrc, Rrc, Rrc, Rrc, Rrc, Rrc, Xos
Xos, Urb, Urb, Urb, Urb, Ai^Yfro, Ai^Yfro, Ai^Yfro, Ai^Yfro, Ai^Yfro, Ai^Yfro, Ai^Yfro, Urb, Urb, Urb, Urb, Xos, Rrc, Rrc, Rrc, Rrc, Rrc, Rrc, Rrc, Rrc, Rrc, Rrc, Rrc, Rrc, Irs^Es, Irs, Icr, Icr^Es, Icr, Irs, Irs, Rrc, Rrc, Rrc, Rrc, Rrc, Rrc, Rrc^Es, Rrc, Rrc, Xos
Xos, Urb, Urb, Urb, Urb, Urb, Urb, Ai^Yfro, Urb, Ai^Yfro, Ai^Yfro, Ai^Yfro, Urb, Urb, Urb, Urb, Urb, Urb, Rrc, Rrc, Rrc, Rrc, Rrc, Rrc, Rrc, Rrc, Rrc, Rrc, Xos, Rrc, Rrc, Icr, Icr, Icr, Rrc, Xos, Rrc, Rrc, Rrc, Rrc, Rrc, Rrc, Rrc, Rrc, Rrc, Xos
Xos, Xos, Xos, Urb, Xos, Urb, Urb, Urb, Urb, Urb, Urb, Urb, Urb^Es, Urb, Urb, Urb, Xos, Urb, Rrc, Rrc, Rrc, Rrc, Rrc, Rrc, Rrc, Rrc, Rrc, Rrc, Xos, Rrc, Rrc, Rrc, Rrc, Rrc, Rrc, Xos, Rrc, Rrc, Rrc, Rrc, Rrc, Rrc, Rrc, Rrc, Xos, Xos
Xos, Xos, Xos, Xos, Xos, Xos, Xos, Urb, Xos, Urb, Urb, Urb, Urb, Urb, Urb, Urb, Urb, Xos, Rrc, Rrc, Rrc, Rrc, Rrc, Rrc^Es, Rrc, Rrc, Rrc, Rrc, Rrc, Rrc, Rrc^Esd, Rrc, Rrc, Rrc, Rrc, Rrc, Rrc, Rrc, Rrc, Rrc, Rrc, Rrc, Rrc, Rrc, Xos, Xos
Xos, Xos, Xos, Xos, Xos, Xos, Xos, Xos, Xos, Xos, Xos, Urb, Urb, Urb, Urb, Urb, Urb, Xos, Rrc, Rrc, Rrc, Rrc, Rrc, Rrc, Rrc, Rrc, Rrc, Rrc, Rrc, Rrc, Rrc, Rrc, Rrc, Rrc, Rrc, Rrc, Rrc, Rrc, Rrc, Rrc, Rrc, Rrc, Rrc, Rrc, Rrc, Xos
Xos, Xos, Xos, Xos, Urb, Urb, Urb, Xos, Xos, Xos, Xos, Xos, Xos, Urb, Urb, Urb, Urb, Xos, Xos, Rrc, Rrc, Rrc, Rrc, Rrc, Rrc, Rrc, Rrc, Rrc, Xos, Rrc, Rrc, Rrc, Rrc, Rrc, Rrc, Xos, Rrc, Rrc, Rrc, Rrc, Rrc, Rrc^Esd, Rrc, Rrc, Rrc, Xos
Xos, Xos, Urb, Urb, Urb, Urb^Esd, Urb, Urb, Urb, Xos, Xos, Xos, Xos, Xos, Urb, Urb, Urb, Urb, Xos, Rrc, Rrc, Rrc, Rrc, Rrc, Rrc, Rrc, Rrc, Rrc, Xos, Rrc, Rrc, Rrc, Rrc, Rrc, Rrc, Xos, Rrc, Rrc, Rrc, Rrc, Rrc, Rrc, Rrc, Rrc, Rrc, Xos
Xos, Xos, Urb, Urb, Urb, Urb, Urb, Urb, Urb, Urb, Urb, Xos, Xos, Xos, Xos, Urb, Urb, Urb, Xos, Rrc, Xos, Rrc, Rrc, Rrc, Rrc, Rrc, Rrc, Rrc, Rrc, Rrc, Rrc, Rrc, Rrc^Es, Rrc, Rrc, Rrc, Rrc, Rrc, Rrc, Rrc, Rrc, Rrc, Rrc, Rrc, Rrc, Xos
Xos, Xos, Urb, Urb, Urb, Xos, Xos, Urb, Urb, Urb, Urb, Urb, Urb, Xos, Xos, Xos, Xos, Xos, Xos, Xos, Xos, Xos, Xos, Xos, Xos, Rrc, Xos, Rrc, Rrc, Rrc, Rrc, Rrc, Rrc, Rrc, Rrc, Rrc, Rrc, Rrc, Rrc, Rrc, Rrc, Rrc, Rrc, Rrc, Xos, Xos
Xos, Xos, Xos, Xos, Urb, Urb, Urb, Xos, Xos, Urb, Urb, Urb, Xos, Urb, Rrc, Xos, Xos, Xos, Xos, Xos, Xos, Xos, Xos, Xos, Xos, Xos, Xos, Xos, Rrc, Rrc, Rrc, Rrc, Rrc, Rrc, Xos, Rrc, Xos, Rrc, Xos, Rrc, Rrc, Rrc, Rrc, Rrc, Xos, Xos
Xos, Xos, Urb, Urb, Urb^Esd, Urb, Urb, Urb, Urb, Xos, Xos, Xos, Rrc, Rrc, Rrc, Rrc, Rrc, Xos, Rrc, Xos, Rrc, Xos, Rrc, Xos, Rrc, Xos, Xos, Xos, Xos, Rrc, Rrc, Rrc, Xos, Xos, Xos, Xos, Xos, Xos, Xos, Xos, Xos, Xos, Xos, Xos, Xos, Xos
Xos, Xos, Urb, Urb, Urb, Urb, Urb, Urb, Xos, Xos, Rrc, Rrc, Rrc, Rrc, Rrc, Rrc, Rrc, Rrc, Rrc, Rrc, Rrc, Rrc, Rrc, Rrc, Rrc, Rrc, Rrc, Rrc, Rrc, Rrc, Rrc, Rrc, Rrc, Rrc, Rrc, Rrc, Rrc, Rrc, Rrc, Rrc, Rrc, Xos, Rrc, Xos, Xos, Xos
Xos, Xos, Xos, Urb, Urb, Urb, Xos, Xos, Rrc, Rrc, Rrc, Rrc, Rrc, Rrc, Rrc, Rrc, Rrc, Rrc, Rrc, Rrc, Rrc^Esd, Rrc, Rrc, Rrc, Rrc, Rrc, Rrc, Rrc, Rrc, Rrc, Rrc, Rrc, Rrc, Rrc, Rrc, Rrc, Rrc, Rrc, Xos, Rrc, Rrc, Rrc, Rrc, Rrc, Xos, Xos
Xos, Xos, Xos, Xos, Xos, Xos, Rrc, Rrc, Rrc, Rrc, Rrc, Rrc, Rrc^Es, Rrc, Rrc, Rrc, Rrc, Rrc, Rrc, Rrc, Rrc, Rrc, Rrc, Rrc, Rrc, Rrc, Rrc, Rrc, Rrc, Rrc, Xos, Xos, Xos, Rrc, Rrc, Rrc, Rrc, Xos, Xos, Xos, Rrc, Rrc, Rrc, Rrc, Xos, Xos
Xos, Xos, Xos, Xos, Xos, Xos, Xos, Rrc, Xos, Rrc, Rrc, Rrc, Rrc, Rrc, Rrc, Rrc, Urb, Urb, Urb, Urb, Urb, Rrc, Rrc, Rrc, Rrc, Rrc, Rrc, Rrc, Rrc, Rrc, Rrc, Xos, Rrc, Rrc, Rrc, Rrc^Es, Rrc, Rrc, Rrc, Rrc, Rrc, Rrc, Rrc, Rrc, Xos, Xos
Xos, Xos, Xos, Xos, Xos, Xos, Xos, Xos, Xos, Xos, Xos, Rrc, Xos, Rrc, Rrc, Rrc, Urb, Urb, Urb, Urb, Urb, Urb, Urb, Urb, Rrc, Rrc, Rrc, Rrc^Es, Rrc, Rrc, Rrc, Rrc, Rrc, Rrc, Rrc, Rrc, Rrc, Rrc, Rrc, Rrc, Rrc, Rrc, Rrc, Rrc, Xos, Xos
Ai, Xos, Xos, Xos, Ai, Xos, Xos, Xos, Xos, Xos, Xos, Xos, Xos, Rrc, Rrc, Urb, Urb, Urb, Aa, Urb, Aa, Urb, Urb, Urb, Urb, Rrc, Rrc, Rrc, Rrc, Rrc, Rrc, Rrc, Rrc, Rrc, Rrc, Xos, Xos, Rrc, Rrc, Rrc, Rrc, Rrc, Xos, Xos, Xos, Xos
Ai, Ai, Ai, Ai, Wog, Ai, Ai, Xos, Xos, Xos, Xos, Xos, Xos, Xos, Xos, Xos, Xos, Aa, Ai, Aa, Ai, Aa, Xos, Urb, Urb, Rrc, Xos, Rrc, Xos, Rrc, Xos, Xos, Xos, Xos, Xos, Xos, Xos, Xos, Xos, Xos, Xos, Xos, Xos, Xos, Xos, Xos
Ai, Ai, Ai, Ai, Ai, Wog, Ai, Ai, Ai, Ai, Aa^Fpa, Xos, Xos, Xos, Xos, Xos, Xos, Ss, Ss, Ss, Rb, Ai, Xos, Xos, Xos, Xos, Xos, Xos, Xos, Xos, Xos, Xos, Xos, Xos, Xos, Xos, Xos, Xos, Xos, Xos, Xos, Xos, Xos, Xos, Xos, Xos
Ai, Ai, Ai, Ai, Ai, Ai, Ai, Ai, Ai, Ai, Ai, Ai, Ai, Xos, Xos, Xos, Ai, Ss, Ss, Aa, Aa, Ai, Ai, Xos, Xos, Xos, Xos, Wog, Ai, Ai, Ai, Ai, Ai, Ai, Ai, Ai, Ai, Xos, Xos, Xos, Xos, Xos, Xos, Xos, Ai, Xos
Ai, Ai, Ai, Ai, Ai, Ai, Ai, Ai, Ai, Ai, Ai, Ai, Ai, Ai, Ai, Ai, Ai, Ai, Ai^Bw/r, Rp, Ai, Aa, Ai, Xos, Xos, Xos, Ai, Aa^Fpa, Ai, Ai, Ai, Ai, Ai, Ai, Ai, Ai, Ai, Ai, Ai, Xos, Xos, Xos, Ai, Ai, Ai, Ai
Ai, Ai, Ai, Ai, Ai, Ai, Ai, Ai, Ai, Ai, Ai, Ai, Ai, Ai, Ai, Ai, Ai, Ss, Ai, Ai, Ss, Ai, Ai, Ai, Ai, Ai, Ai, Ai, Wog, Ai, Ai, Ai, Ai, Ai, Ai, Ai, Ai, Ai, Ai, Ai, Ai, Ai, Ai, Ai, Ai, Ai
Ai, Ai, Ai, Ai, Ai, Ai, Ai, Ai, Ai, Ai, Ai, Ai, Ai, Ai, Ss, Ai, Ai, Ai, Ss, Ai, Ai, Ai, Ss, Ai, Ai, Ai, Ai, Ai, Ai, Ai, Ai, Ai, Ai, Ai, Ai, Ai, Ai, Ai, Ai, Ai, Ai, Ai, Ai, Ai, Ai, Ai
Aa, Ai, Ai, Ai, Ai, Ai, Ai, Ai, Ai, Ai, Ai, Ai, Ai, Ai, Ai, Ai, Ai, Ss, Ai, Ss, Ss, Ss, Ai, Ai, Aa, Aa, Aa, Ai, Ai, Ai, Ai, Ai, Ai, Ai, Ai, Ai, Ai, Ai, Ai, Ai, Ai, Ai, Ai, Ai, Ai, Ai
Aa, Aa, Aa, Ai, Ai, Ai, Ai, Ai, Ai, Ai, Ai, Wog, Wog, Wog, Ai, Ai, Ai, Ai, Aa, Ss, Ai, Ai, Ss, Aa^Fpa, Aa^Fpa, Aa^Vca, Aa, Ai, Ai, Ai, Ai, Ai, Ai, Ai, Ai, Ai, Ai, Ai, Ai, Ai, Ai, Ai, Ai, Ai, Ai, Ai
Ha, Aa, Aa, Aa, Aa, Ai, Ai, Ai, Ai, Ai, Ai^Bw/r, Wog^Bw/r, Ai, Wog, Ai, 1 Ai, Ai, Ai, Ss, Aa, Ai, Ai, Ai, Aa^Fpa, Aa, Aa, Ai, Ai, Ai, Ai, Ai, Ai, Ai, Ai, Ai, Ai, Ai, Ai, Ai, Ai, Ai, Ai, Ai, Ai, Ai, Ai
Aa^Fpa, Aa, Aa, Aa, Aa, Aa, Aa, Ai, Rb, Ai^Bw/r, Ai, Ai, Ai, Ai, Ai, Ai, Ai, Ai, Ai, Ai, Ai, Ai, Ai, Aa, Ai, Ai, Ai, Ai, Ai, Ai, Ai, Ai, Ai, Ai, Ai, Ai, Ai, Ai, Ai, Ai, Ai, Ai, Ai, Ai, Aa, Aa
Aa^Fpa, Aa^Vca, Aa, Aa, Rb, Aa, Rb, Rb, Aa, Aa, Aa, Aa, Aa, Ai, Aa, Ai, Aa, Ai, Ai, Ai, Ai, Ai, Ai, Ai, Ai, Ai, Ai, Ai, Ai, Ai, Ai, Ai, Ai, Ai, Ai, Ai, Ai, Ai, Ai, Ai, Ai, Ai, Aa, Aa, Aa, Aa
Aa^Fpa, Aa^Fpa, Rb, Rb, Rb, Rb, Aa, Aa, Aa, Aa^Vca, Aa^Fpa, Aa, Aa^Fpa, Aa, Aa, Aa, Aa, Aa, Aa, Ai, Ai, Ai, Ai, Ai, Ai, Ai, Ai, Ai, Ai, Ai, Ai, Ai, Ai, Ai, Ai, Ai, Ai, Ai, Ai, Ai, Aa, Aa, Aa, Aa, Ha, Ha
Aa^Fpa, Aa^Fpa, Rb, Rb, Aa, Aa, Aa, Aa, Aa, Aa^Fpa, Aa^Fpa, Aa^Fpa, Aa^Fpa, Aa^Fpa, Aa^Fpa, Aa, Aa, Aa, Aa, Aa, Aa, Aa, Aa, Ai, Ai, Ai, Ai, Ai, Ai, Ai, Ai, Ai, Ai, Ai, Aa, Aa, Aa, Aa, Aa, Aa, Aa, Aa, Ha, Ha, Ha, Ha
