Xu, Xu, Xu, Xu, Uh^Ii, Aa, Uu^Ii, Aa, Xu, Xu, Xu, Xu, Xu, Xu, Xu, Xu, Xu, Xu, Xu, Xu, Xu, Xu, Xu, Xu, Xu, Xu, Xu, Xu, Xu, Xu, Xu, Xu, Xu, Xu, Xu, Xu, Xu, Xu, Xu, Xu, Xu, Xu, Xu, Xu, Xu, Xu, Xu, Xu, Xu, Xu, Xu, Xu, Xu, Xu, Xu, Xu, Xu, Xu, Xu, Xu, Xu, Xu, Xu, Xu, Wwg, Wwg, Wwg
Xu, Xu, Xu, Xu, Xu, Uh^Ii, Uu^Ii, Uh^Ii, Xu, Xu, Xu, Xu, Xu, Xu, Xu, Xu, Xu, Xu, Xu, Xu, Xu, Xu, Xu, Xu, Xu, Xu, Xu, Xu, Xu, Xu, Xu, Xu, Xu, Xu, Xu, Xu, Xu, Xu, Xu, Xu, Xu, Xu, Xu, Xu, Xu, Xu, Xu, Xu, Xu, Xu, Xu, Xu, Xu, Xu, Xu, Xu, Xu, Xu, Xu, Xu, Xu, Xu, Xu, Xu, Wwg, Wwg, Wog
Xu, Xu, Xu, Xu, Xu, Xu, Xu, Uu^Ii, Ur, Xu, Uu, Xu, Uu, Xu, Uu, Xu, Uu, Xu, Uu, Uu^Uf, Uu^Uf, Xu, Xu, Xu, Xu, Xu, Xu, Xu, Xu, Xu, Xu, Xu, Xu, Xu, Xu, Xu, Xu, Xu, Xu, Xu, Xu, Xu, Xu, Xu, Xu, Xu, Xu, Xu, Xu, Xu, Xu, Xu, Uu, Uu, 1 Uu, Uu, Uu, Uu, Uu^Edt, Uu^Edt, Ds^Edt, Ds, Wwg, Wwg, Wog, Wog, Wog
Xu, Xu, Xu, Xu, Xu, Xu, Xu, Xu, Uu, Ur, Uu, Uu, Uu, Uu, Uu^Hsry, Uu, Uu, Uu, Uu, Uu, Uu, Uu^Uf, Xu, Xu, Xu, Xu, Xu, Xu, Xu, Xu, Xu, Xu, Xu, Xu, Xu, Xu, Xu, Xu, Xu, Xu, Xu, Xu, Xu, Xu, Xu, Xu, Xu, Xu, Xu, Xu, Xu, Uu, Uu, Uu, Ur, Uu, Uu, Uu, Uu^Edt, Ds^Edt, Ds, Wwg, Wwg, Wwg, Wog, Wog, Wog
Xu, Xu, Xu, Xu, Uu^Uf, Uu^Uf, Uu, Uu, Ur, Uu, Uu, Uu, Uu, Uu, Uu, Uu, Uu, Uu, Ds, Uu, Uu, Uu, Uu, Xu, Xu, Xu, Xu, Xu, Xu, Xu, Xu, Xu, Xu, Xu, Xu, Xu, Xu, Xu, Xu, Xu, Xu, Xu, Xu, Xu, Xu, Xu, Xu, Xu, Xu, Xu, Uu^Edt, Uu^Edt, Uu^Edt, Uu, Uu, Uu, Uu, Uu, Ds, Ds, Wwg, Wwg, Wwg, Wog, Wog, Wog, Wog
Xu, Xu, Uu^Uf, Uu^Uf, Uu^Uf, Uu^Uf, Uu, Uu, Uu, Ur, Ds, Ds, Ds, Uu, Ds, Uu, Ds, Ds, Ds, Ds, Ds, Uu, Ds, Uu, Ds, Xu, Xu, Xu, Xu, Xu, Xu, Xu, Xu, Xu, Xu, Xu, Xu, Xu, Xu, Xu, Xu, Xu, Xu, Xu, Xu, Xu, Xu, Xu, Xu, Xu, Uu^Edt, Uu^Edt, Ur, Uu, Uu, Uu, Ds, Ds, Ds, Wwrg, Wwrg, Wwrg, Wwg, Wog, Wog, Wog, Wog
Xu, Xu, Uu^Uf, Uu, Uu, Uu, Ds, Ds, Ds, Ds, Wwg, Wwg, Wwg, Ds, Wwg, Ds, Ds, Ds, Wwg, Wwrg, Wwg, Ds, Wwg, Ds, Wwg, Ds, Wwg, Xu, Wog, Xu, Xu, Xu, Xu, Xu, Xu, Xu, Xu, Xu, Xu, Xu, Xu, Xu, Xu, Xu, Xu, Xu, Xu, Xu, Uu, Uu, Uu, Uu^Edt, Ur, Uu^Es, Uu, Uu, Ds, Wwrg, Wwrg, Wwrg, Wwg, Wwg, Wog, Wog, Wog, Wog, Wog
Qxu, Uu^Uf, Uu, Uu, Uu, Ds, Ds, Ds, Wwg, Wwg, Wwf, Wwg, Wwf, Wwf, Wwg, Wwg, Wwg, Wwg, Wwg, Wog, Wog, Wwg, Wog, Wwg, Wog, Wwg, Wog, Wog, Wog, Wog, Wog, Wog, Wog, Xu, Xu, Xu, Xu, Xu, Xu, Xu, Xu, Xu, Uu, Uu, Uu, Uu, Uu, Uu, Uu, Uu, Ur^Es, Ur, Uu, Uu, Uu, Ds, Wwrg, Wwg, Wwrg, Wwrg, Wwg, Wwg, Wog, Wog, Wog, Wog, Wog
Qxu, Qxu, Qxu, Uu, Ds, Ds, Wwrg, Wwg, Wwg, Wwf, Wwf, Wwf, Wwf, Wwf, Wwg, Wwg, Wwg, Wwg, Ds, Wwg, Wwg, Wog, Wwg, Wog, Wwg, Wog, Wwg, Wog, Wwg, Wog, Wog, Wog, Wog, Wog, Wog, Wwrg, Wwrg, Xu, Xu, Xu, Ds, Uu, Uu, Uu, Uu, Uu^Dr, Uu, Ur, Ur, Uu^Es, Uu, Ur, Ur, Uu, Uu, Ds, Ds, Wwg, Wwg, Wwrg, Wwg, Wog, Wog, Wog, Wog, Wog, Wog
Qxu, Qxu, Qxu, Wwrg, Wwg, Wwrg, Wwg, Wwg, Wwg, Wwf, Ds, Ds, Ds, Ds^Edt, Ds^Edt, Wwg, Ds^Edt, Ds, Uu^Hsry, Ds, Ds, Wwg, Uu^Hsry, Wwg, Ds, Wwg, Ds, Wwg, Ds, Wwg, Wwg, Wog, Wog, Wog, Wwrg, Wwrg, Wwg^Hsry, Xu, Wwrg, Ds, Ds, Uu, Uu, Uu, Uu, Uu, Ur, Uu, Ur, Uu, Xu, Uu, Ds, Ds, Ds, Ds, Wwg, Wwg, Wwg, Wwg, Wog, Wog, Wog, Wog, Wog, Wog, Wog
Qxu, Qxu, Qxu, Wwf, Wwg, Wwg, Wwg, Wwg, Ds, Ds, Uu, Ur, Ur, Uu^Edt, Uu^Edt, Ds^Edt, Uu^Es, Uu^Es, Uu^Dr, Uu^Es, Uu^Dr, Xu, Xu, Uu^Hsry, Uu, Ds, Uu, Ds, Uu, Ds, Ds, Ds, Uu^Uf, Wog, Wwrg, Wwg^Hsry, Wwg^Hsry, Wwg^Hsry, Wwg^Hsry, Wwrg, Wwrg, Ds, Ds, Ds, Ds, Ds, Ds, Ds, Ds, Xu, Xu, Xu, Wog, Wwg, Wwg, Wwg, Wwg, Wwg, Wog, Wog, Wog, Wog, Wog, Wog, Wog, Wog, Wog
Qxu, Qxu, Qxu, Qxu, Qxu, Wwrg, Ds, Ds, Uu, Uu, Uu^Uf, Uu^Uf, Uu, Ur, Uu, Uu, Uu, Uu^Es, Uu^Es, Uu^Es, Uu^Es, Uu^Hsry, Xu, Xu, Uu, Uu, Uu, Uu, Uu, Uu, Uu^Uf, Uu^Uf, Wwg, Wog, Wwrg, Wwg^Hsry, Wwg^Hsry, Wwg^Hsry, Wwg^Hsry, Wwg^Hsry, Wwg^Hsry, Wwrg, Wwrg, Wwg, Wwg, Wwrg, Wwg, Wwg, Wwg, Xu, Xu, Wog, Wog, Wog, Wog, Wog, Wog, Wog, Wog, Wog, Wog, Wog, Wog, Wog, Wog, Wog, Wog
Qxu, Qxu, Qxu, Qxu, Qxu, Qxu, Uu, Uu, Uu, Uu, Uu^Uf, Uu, Ur, Ur, Uu, Ur, Ur, Uu^Dr, Uu, Uu, Uu, Uu^Es, Uu, Uu^Uf, Uu, Uu, Ur, Uu, Uu, Uu, Ds, Wwg, Wog, Wog, Wwg, Wwrg, Wwg^Hsry, Wwg^Hsry, Wwg^Hsry, Wwg^Hsry, Wwrg, Wwg, Wog, Wog, Wog, Wwg, Wog, Wwg, Wwf, Wwg, Wwg, Wog, Wog, Wog, Wog, Wog, Wog, Wog, Wog, Wog, Wog, Wog, Wog, Wog, Wog, Wog, Wog
Qxu, Qxu, Qxu, Qxu, Qxu, Uu, Uu, Uu^Uf, Uu^Uf, Ur, Uu^Uf, Uu^Uf, Uu^Uf, Uu, Uu, Uu, Uu, Ur, Ur, Uu, Uu, Uu, Ds^Es, Uu, Uu, Ur, Uu^Dr, Ur, Ur, Ds, Wwg, Wog, Wog, Wog, Ds, Wwg, Ds, Wwrg, Wwg^Hsry, Wwg^Hsry, Wog, Wog, Wog, Wog, Wog, Wog, Wwg, Wwg, Wwf, Wwg, Wwg, Wog, Wog, Wog, Wog, Wog, Wog, Wog, Wog, Wog, Wog, Wog, Wog, Wog, Wog, Wog, Wog
Qxu, Qxu, Qxu, Qxu, Wwrg, Uu, Uu, Uu, Uu, Uu, Uu, Uu^Es, Uu, Uu, Xu, Uu^Hsry, Uu^Hsry, Ur, Ur, Uu, Ds, Ds, Wwg, Ds, Ds, Uu, Uu, Uu, Ds^Es, Ds, Wwg, Wog, Wwg, Wwg, Ds, Ds, Ds, Wwrg, Wwrg, Wwg, Ds, Wwrg, Wwg, Wog, Wog, Wwg, Ds, Wwg, Wwg, Wwf, Wwg, Wwg, Wwg, Wog, Wog, Wog, Wog, Wog, Wog, Wog, Wog, Wog, Wog, Wog, Wog, Wog, Wog
Qxu, Qxu, Qxu, Wwg, Wwg, Ds, Ds, Ds, Ds, Ds, Ds, Ds^Es, Ds, Uu^Es, Uu^Hsry, Xu, Uu^Hsry, Ds^Es, Ds, Ds, Wwg, Wwg, Wog, Wwg, Ds, Uu, Ds, Ds, Ds, Ds, Wog, Wog, Wwg, Ds, Uu, Uu, Xu, Wwg^Hsry, Xu, Ds, Wwg, Wwg, Wog, Wog, Wog, Wwg, Wwg, Wwg, Wwg, Wwg, Ds, Ds, Wwg, Wwg, Wog, Wog, Wog, Wog, Wog, Wog, Wog, Wog, Wog, Wog, Wog, Wog, Wwg
Qxu, Qxu, Qxu, Wwg, Wwf, Wwg, Wwg, Wwg, Wwg, Wwg, Wwg, Ds, Wwg, Ds^Es, Wwg, Uu^Hsry, Wwg, Wwg, Wwg, Wwg, Wwg, Wog, Wwg, Wwg, Ds, Ds, Wwg, Wwrg, Wwg^Hsry, Wwrg, Wwrg, Wwg, Wwg, Uu^Uf, Ur, Ur, Xu, Xu, Xu, Wwg, Wwg, Wog, Wwg, Wwg, Wwg, Wog, Wwg, Wwg, Wwg, Ds, Ds, Wwg, Wwg, Wwg, Wog, Wog, Wog, Wog, Wog, Wog, Wwg, Wog, Wwg, Wwg, Wwg, Wwg, Wwg
Qxu, Qxu, Wwg, Wwrg, Wwf, Wwrg, Wwg, Wwg, Wog, Wwg, Wog, Wwg, Wog, Wwg, Wog, Wwg, Wwg, Wwg, Wwrg, Wwg, Wog, Wog, Wwg, Ds, Wwg, Wwg, Wog, Wog, Wwrg, Ds, Ds, Wwg, Ds, Uu^Uf, Ur, Uu, Ds, Xu, Ds, Wwg, Wwrg, Wog, Wwrg, Ds, Wwrg, Wwg, Wwg, Wwg, Ds, Ds, Wwg, Wwg, Wog, Wog, Wog, Wog, Wog, Wog, Wwg, Wwg, Wwg, Wwg, Ds, Wwg, Wwrg, Wwrg, Xu
Qxu, Qxu, Qxu, Wwg, Wwg, Wwg, Wwg, Wwf, Wog, Wog, Wog, Wog, Wog, Wog, Wog, Wog, Wog, Wwg, Wwg, Wwg, Wwg, Wog, Wog, Wwg, Wog, Wog, Wwg, Wwg, Ds, Ds, Wwg, Ds, Ds, Uu^Uf, Uu^Uf, Uu, Ds, Ds, Wwg, Ds, Ds, Wwg^Hsry, Wog, Wwg, Wwrg, Wwrg, Wwrg, Ds, Ds, Wwrg, Wwg, Wwg, Wog, Wog, Wog, Wog, Wog, Wwg, Wwrg, Wwrg, Ds, Ds, Ds, Wwrg, Wwrg, Xu, Xu
Qxu, Qxu, Qxu, Qxu, Wwrg, Wog, Wog, Wwg, Wwf, Wog, Wog, Wog, Wog, Wog, Wog, Wog, Wog, Wwf, Wwf, Ds, Wwg, Wog, Wwrg, Wog, Wwg, Wwg, Ds, Ds, Ds, Wwrg, Ww^Vm, Wwg, Ds, Uu^Uf, Uu^Uf, Ds, Wwrg, Wwg, Wwg, Wwg, Ds, Wwrg, Wwf, Wwg, Wwg, Wwg, Ds, Ds, Ds, Wwg, Wog, Wog, Wog, Wog, Wog, Wog, Wog, Wwg, Wwrg, Ds, Uu, Uu, Ds, Wwrg, Wwrg, Xu, Xu
Qxu, Qxu, Qxu, Qxu, Wwrg, Wog, Wog, Wwg, Wwf, Wwg, Wog, Wog, Wog, Wog, Wog, Wog, Wog, Wog, Wog, Wwf, Wwf, Wwrg, Ds, Wwg, Ds, Ds, Ds, Uu^Uf, Ds, Wwrg, Wwg, Wwg, Ds, Uu^Uf, Uu^Uf, Wwrg, Wwrg, Wwg, Wwg, Wwg, Ww^Vm, Wwg, Wwf, Wwg, Ds, Ds, Uu, Ur, Ds, Wwg, Wog, Wog, Wog, Wog, Wog, Wog, Wog, Wwg, Ds, Ds, Ds, Ds, Wwg, Wwg, Wwg, Xu, Xu
Qxu, Qxu, Wwg, Wwg, Wwrg, Wwrg, Wwg, Wwf, Wwg, Wwrg, Wwg, Wog, Wwg, Wwg, Wwg, Wwg, Wwg, Wog, Wog, Wog, Wog, Wwf, Wwg, Wwg, Wwg, Wwg, Wwg, Ds, Wwg, Wwg, Wwf, Ds, Wwf, Uu^Uf, Wwg, Uu, Ds, Ds, Ds, Ds, Wwg, Wog, Wwg, Ds, Uu, Uu^Hsry, Ur, Uu, Ds^Edt, Wwg, Wwg, Wog, Wog, Wog, Wog, Wog, Wog, Wwg, Wwg, Wwrg, Wwg, Wwg, Wwg, Wwg, Wwg, Xu, Xu
Qxu, Qxu, Wwrg, Wwrg, Wwrg, Wwg, Wwg, Wwg, Wwg, Wwg, Wwg, Wwg, Ds, Ds, Ds, Ds, Wwg, Wwg, Wog, Wog, Wog, Wog, Wwg, Wwg, Wwg, Wog, Wog, Wog, Wog, Wog, Wog, Ds, Wog, Wwg, Wwf, Wwg, Wwg, Wwg, Wwg, Wwg, Wog, Wog, Wwg, Ds, Uu, Ur, Uu^Dr, Uu, Ds^Edt, Wwg, Wwg, Wwg, Xu, Wog, Wog, Wog, Wwg, Wwg, Wwg, Wwg, Wwg, Wwg, Wwg, Wwg, Uu, Xu, Xu
Qxu, Qxu, Uu, Ds, Ds, Ds, Ds, Ds, Ds, Ds, Ds, Ds, Uu^Edt, Ds^Edt, Wwg, Wwg, Wog, Wog, Wwrg, Wwg, Wwg, Wwg, Wwg, Wwrg, Wwrg, Wwg, Xu, Wwg, Wwg, Wwg, Wwg, Wog, Wwg, Wwg, Wog, Wwg, Wog, Wog, Wog, Wog, Wwg, Wwg, Ds, Ds, Uu, Uu, Uu, Uu, Ds^Edt, Ds^Edt, Ds^Edt, Xu, Xu, Xu, Xu, Wwg, Wwg, Wwg, Wwg, Wwg, Wwg, Wwg, Uu, Uu, Xu, Xu, Xu
Qxu, Uu, Uu, Uu, Uu^Uf, Uu, Uu, Ur, Ur^Es, Uu, Uu, Uu, Uu, Ds^Edt, Wwg, Wog, Wog, Wwg^Hsry, Wwg^Hsry, Ds^Es, Ds^Es, Ds, Ds^Es, Ds, Ds, Uu^Hsry, Xu, Xu, Ds, Ds, Ds, Wwg, Ds, Wwg, Wwg, Wog, Wwg, Wwg, Wwg, Wwg, Ds, Ds, Uu, Uu, Uu, Ur, Rb^Es, Uu, Uu^Edt, Ds^Edt, Ds, Xu, Xu, Xu, Xu, Uu, Uu, Uu, Uu, Uu, Uu, Uu, Uu, Uu, Xu, Xu, Xu
Qxu, Qxu, Qxu, Uu, Uu^Uf, Uu^Uf, Uu^Uf, Uu, Uu, Uu, Uu^Uf, Uu, Uu, Ds^Edt, Ds^Edt, Wwg, Wwg, Wog, Wwg^Hsry, Ds^Es, Ds, Uu^Es, Uu, Uu, Uu, Xu, Xu, Uu^Hsry, Uu, Uu, Uu, Ds, Uu, Ds, Wwg, Wog, Wwg, Wwg, Wwrg, Ds, Uu, Uu, Ur, Uu, Rb^Es, Rb, Rb, Uu, Uu, Uu, Uu, Uu, Uu, Xu, Uu, Uu, Uu, Uu, Uu, Uu, Uu^Edb, Uu, Uu^Edb, Xu, Xu, Xu, Xu
Qxu, Qxu, Qxu, Uu, Uu, Uu^Uf, Uu^Uf, Uu, Uu, Uu^Uf, Uu^Uf, Uu^Uf, Uu^Uf, Uu^Edt, Uu^Edt, Ds^Edt, Wwg, Wog, Wog, Wwg^Hsry, Wwrg, Ds, Ds, Ur, Ur^Es, Uu^Uf, Ur, Uu^Dr, Ur^Es, Ur, Uu, Uu, Ds, Ds, Wwg, Wog, Wwg, Ds, Ds, Ds, Uu, Ur, Ur, Rb^Es, Rb^Es, Rb, Rb, Rb, Ur, Uu, Uu^Es, Uu, Uh, Uu, Uu, Uu, Uu^Hsry, Uu, Uu, Uu, Uu^Edb, Uu^Edb, Uu^Edb, Xu, Xu, Xu, Xu
Qxu, Qxu, Qxu, Uu, Uu, Uu, Ur^Hsry, Uu, Uu^Hsry, Xu, Xu, Uu^Uf, Uu^Uf, Uu, Uu, Ds^Edt, Ds, Wwg, Wwrg, Wog, Wog, Wwg, Wwrg, Ds, Ds, Uu, Uu, Uu^Uf, Uu, Ur, Ds, Ds, Wwrg, Wwg, Wwg, Wog, Wwg, Ds, Uu, Uu, Uu^Es, Ur^Es, Uu^Es, Uu, Uu, Ur^Es, Uu, Ur, Uu, Ur, Ur, Uu, Uh, Uh, Uu, Uu, Uu, Uu, Uu, Uh, Uu^Edb, Uu^Edb, Uu^Edb, Uu^Edb, Xu, Xu, Xu
Qxu, Qxu, Qxu, Qxu, Uu, Uu, Uu^Dr, Uu, Xu, Xu, Uu^Hsry, Uu^Uf, Uu^Uf, Uu, Uu, Uu, Uu, Ds, Ds, Wwg^Hsry, Wog, Wwg^Hsry, Wwrg, Ds^Es, Ds^Es, Ds, Ds, Uu, Ds, Ds, Wwg, Wwg, Wwrg, Wwrg, Wwrg, Wwg, Ds, Ds, Uu, Uu, Ur^Es, Uu^Dr, Uu^Es, Uu^Hsry, Uu, Uu, Xu, Uu^Uf, Xu, Uu, Uu, Uu, Xu, Uu, Uu, Uu, Uu, Uu, Uu, Uu^Edb, Uu^Edb, Uu^Edb, Uu^Edb, Xu, Xu, Xu, Xu
Qxu, Qxu, Qxu, Uu, Uu^Uf, Uu^Uf, Uu^Uf, Uu, Uu, Xu, Uu, Uu^Uf, Uu, Uu, Ur^Es, Uu, Uu, Uu^Edt, Ds^Edt, Wwrg, Wwrg, Wog, Wog, Wwrg, Wwg, Wwg, Wwg, Ds, Ds^Es, Wwrg, Wwg, Wwg, Wwg, Wwg, Ds, Ds, Uu, Uu, Ur^Es, Ur, Ur, Uu^Es, Uu^Hsry, Uu, Xu, Xu, Xu, Xu, Xu, Xu, Xu, Ur, Uu, Uu, Uu, Uu, Xu, Uu, Uu, Uu, Uu, Uu^Edb, Uu^Edb, Xu, Xu, Xu, Xu
Qxu, Qxu, Qxu, Uu, Uu, Uu^Uf, Uu^Uf, Ur, Uu^Vu, Uu, Ur, Uu, Uu, Uu, Ur, Uu, Uu, Uu^Edt, Uu^Edt, Ds^Es, Ds^Dr, Wwg^Hsry, Wwg^Hsry, Wog, Wog, Wwg, Wwg, Wwrg, Ds, Wwg, Wwg, Wwg, Wwg, Wwg, Ds, Uu, Uu, Uu, Uu, Uu, Uu, Uu^Hsry, Xu, Xu, Xu, Xu, Xu, Xu, Xu, Xu, Xu, Uu, Uu, Ur, Uu^Hsry, Xu, Xu, Xu, Xu, Uu, Xu, Xu, Xu, Xu, Xu, Xu, Xu
Qxu, Qxu, Qxu, Qxu, Uu^Hsry, Uu^Uf, Uu, Uu, Ur, Ur, Uu, Uu, Uu, Ur, Ur, Uu, Uu^Dr, Uu, Uu, Uu, Ds^Es, Ds^Es, Wwrg, Wwrg, Wwg, Wog, Wog, Wwg, Wwg, Wwg, Wwg, Wwg, Ds^Es, Ds, Uu, Uu, Uu^Hsry, Uu^Dr, Ur, Uu, Uu^Uf, Uu^Uf, Xu, Xu, Xu, Xu, Xu, Xu, Xu, Xu, Uu^Uf, Uh, Uh, Ur, Uu, Xu, Xu, Xu, Xu, Xu, Xu, Xu, Xu, Xu, Xu, Xu, Xu
Qxu, Qxu, Qxu, Uu, Uu^Dr, Uu, Uu, Ur, Uu^Hsry, Uu^Hsry, Xu, Uu, Ur, Uu, Uu, Uu, Uu, Uu, Ds, Uu, Ds^Es, Wwrg, Wwg, Wwg, Wwg, Wog, Wog, Wwg, Wwg, Wwg, Wwg, Wwg, Ds, Uu^Es, Uu, Uu, Uu, Uu^Es, Ur, Uu, Uu, Uu^Uf, Uu^Uf, Xu, Xu, Xu, Xu, Xu, Xu, Uu^Uf, Uu^Uf, Uu, Rb, Uh, Uu, Uu, Uu, Xu, Xu, Xu, Uu, Xu, Xu, Xu, Xu, Xu, Xu
Qxu, Qxu, Uu, Uu, Ds, Uu, Uu, Uu, Xu, Xu, Xu, Uu, Uu, Uu, Ds, Ds, Ds, Ds, Wwg, Ds, Wwg, Wwg, Wwg, Wwg, Wog, Wog, Wwg, Wwg, Wwg, Wwg, Ds, Ds, Uu, Uu, Uh, Uh, Uh, Uu, Uu, Ur, Ur^Es, Uu, Uu, Uu^Uf, Uu^Uf, Xu, Xu, Xu, Uu^Uf, Uu^Uf, Uu, Rb, Ur^Es, Ur, Uu, Uu, Uu, Xu, Rb, Uu, Ur, Ur, Uu, Xu, Xu, Xu, Xu
Qxu, Qxu, Qxu, Wwrg, Ds, Ds, Ds, Ds, Ds^Dr, Uu^Hsry, Ds, Uu, Ds, Ds, Wwrg, Wwg, Wwg, Wwg, Wwg, Wwg, Wog, Wog, Wog, Wog, Wwg, Wwg, Wwg, Wwg, Ds, Ds, Uu, Uu, Uu, Uu, Uh, Uh, Uh, Uh, Ur, Uu^Es, Uu, Uu, Ur, Uu^Uf, Ur, Uh, Uu, Uu^Uf, Uu, Uu, Uu, Rb, Rb, Rb, Uu, Uu^Dr, Uu, Rb, Xu, Ur, Ur, Uu, Xu, Xu, Xu, Xu, Xu
Qxu, Qxu, Qxu, Wwf, Wwg, Ds, Wwrg, Ds, Wwg, Ds, Wwg, Ds, Wwg, Ds, Wwrg, Wwrg, Wog, Wwg, Wog, Wog, Wog, Wog, Wog, Wwg, Wwg, Wwg, Ds, Ds, Uu, Uu, Uu, Uu, Uu, Uu, Uu, Uh, Uu, Uu, Uu, Uu, Uu, Uu, Uu^Uf, Ur, Uu, Uh, Ur, Uu, Ur, Uh, Uu, Ur, Ur, Uu, Uu^Vct, Uu, Rb, Xu, Xu, Xu, Xu, Xu, Xu, Xu, Xu, Xu, Xu
Qxu, Qxu, Qxu, Qxu, Qxu, Wwg, Wwrg, Wwg, Wwg, Wwg, Wog, Wwg, Wog, Wwg, Wog, Wog, Wog, Wog, Wog, Wog, Wog, Wog, Wwg, Wwg, Ds, Ds, Uu, Uu, Uu, Uu, Uu^Uf, Uu^Uf, Uu^Uf, Uu, Uu, Uu, Uu, Uu, Xu, Uu, Xu, Xu, Xu, Uu^Uf, Uu, Uu, Uu, Uu, Uu, Uh, Uu, Uu, Rb, Rb, Uh, Uh, Uh, Uu^Vct, Xu, Xu, Xu, Xu, Xu, Xu, Xu, Xu, Xu
Qxu, Qxu, Qxu, Qxu, Qxu, Wwrg, Wwrg, Wwrg, Wwg, Wog, Wog, Wog, Wog, Wog, Wog, Wog, Wog, Wog, Wog, Wog, Wwg, Wwg, Ds, Ds, Uu, Uu, Uu, Uu, Uu^Uf, Uu^Uf, Uu^Uf, Uu^Uf, Uu, Uu, Uu, Uu, Xu, Xu, Xu, Xu, Xu, Xu, Xu, Uu^Uf, Uu, Uu, Xu, Uu, Uu, Uu^Hsry, Uu, Uu^Vct, Uh, Uh, Ql, Qlf, Qlf, Xu, Xu, Xu, Xu, Xu, Xu, Xu, Xu, Xu, Xu
Qxu, Qxu, Qxu, Qxu, Qxu, Qxu, Qxu, Wwrg, Xu, Wwrg, Xu, Wog, Xu, Xu, Xu, Wog, Wog, Wog, Wog, Wwg, Ds, Ds, Uu, Uu, Uu, Uu, Uu, Uu, Uu, Uu, Xu, Uu, Xu, Uu, Xu, Xu, Xu, Xu, Xu, Xu, Xu, Xu, Xu, Xu, Xu, Xu, Xu, Xu, Xu, Uu, Uu, Uh, Uh, Ql, Ql, Qlf, Ql, Qlf, Qlf, Xu, Xu, Xu, Xu, Xu, Xu, Xu, Xu
Qxu, Qxu, Qxu, Qxu, Qxu, Qxu, Qxu, Xu, Xu, Xu, Xu, Xu, Xu, Xu, Xu, Xu, Xu, Wog, Xu, Xu, Xu, Xu, Xu, Xu, Xu, Xu, Xu, Uu, Xu, Xu, Xu, Xu, Xu, Xu, Xu, Xu, Xu, Xu, Xu, Xu, Xu, Xu, Xu, Xu, Xu, Xu, Xu, Xu, Xu, Xu, Xu, Uh, Xu, Qlf, Ql, Ql, Xu, Xu, Qlf, Xu, Xu, Xu, Qlf, Xu, Xu, Xu, Xu
Qxu, Qxu, Qxu, Qxu, Qxu, Qxu, Qxu, Qxu, Qxu, Xu, Xu, Xu, Xu, Xu, Xu, Xu, Xu, Xu, Xu, Xu, Xu, Xu, Xu, Xu, Xu, Xu, Xu, Xu, Xu, Xu, Xu, Xu, Xu, Xu, Xu, Xu, Xu, Xu, Xu, Xu, Xu, Xu, Xu, Xu, Xu, Xu, Xu, Xu, Xu, Xu, Xu, Uu, Uu, Xu, Xu, Xu, Xu, Xu, Xu, Qlf, Qlf, Qlf, Xu, Xu, Xu, Xu, Xu
Qxu, Qxu, Qxu, Qxu, Qxu, Qxu, Qxu, Qxu, Qxu, Xu, Xu, Xu, Xu, Xu, Xu, Xu, Xu, Xu, Xu, Xu, Xu, Xu, Xu, Xu, Xu, Xu, Xu, Xu, Xu, Xu, Xu, Xu, Xu, Xu, Xu, Xu, Xu, Xu, Xu, Xu, Xu, Xu, Xu, Xu, Xu, Xu, Xu, Xu, Xu, Xu, Xu, Xu, Qxu, Qxu, Xu, Xu, Xu, Xu, Xu, Xu, Xu, Qlf, Qlf, Xu, Xu, Xu, Xu
