Xu, Xu, Xu, Xu, Xu, Xu, Xu, Xu, Xu, Xu, Xu, Xu, Xu, Xu, Xu, Xu, Xu, Xu, Xu, Xu, Xu, Xu, Xu, Xu, Xu, Xu, Xu, Xu, Xu, Xu, Xu, Xu, Xu, Xu, Xu, Xu, Xu, Xu, Xu, Xu, Xu, Xu, Xu, Xu, Xu, Xu
Xu, Xu, Xu, Xu, Xu, Xu, Xu, Xu, Xu, Xu, Xu, Xuc, Uh, Xu, Xu, Xu, Xu, Xu, Xu, Xu, Xu, Xu, Xu, Xu, Xu, Xu, Xu, Xu, Uu^Vu, Xu, Xu, Xu, Xu, Xu, Xu, Xu, Xu, Xu, Xu, Xu, Xu, Xu, Xu, Xu, Xu, Xu
Xuc, Xuc, Xuc, Xuc, Xuc, Xu, Xuc, Xuc, Uu^Em, Xuc, Uu, Uu^Em, Ur, Uu, Uu, Uh, Uu, Uu, Ur^Em, Uu^Em, Uu^Em, Xu, Xu, Xu, Xu, Xu, Uh, Uh, Uh, Uu, Uu, Xu, Xu, Xu, Xu, Xu, Xu, Xu, Xu, Xu, Xu, Xu, Xu, Xu, Xu, Xu
Uu, Uu, Uu, Uu, Uu, Uh, Uu, Uu^Es, Ur^Es, Uu^Em, Ur, Ur, Uu, Ur, Ur^Hsry, Ur, Ur, Ur, Ur, Ur^Em, Ur, Uu, Aa^Esa, Uh, Uu, Uu, Uu, Uh, Uu, Uu, Ur, Uu, Ur, Uu, Uu, Uu, Ur, Xu, Uu, Uu, Uu, Ur, Ur, Xu, Xu, Xu
Ur, Uu, 1 Uu, Uu, Ur, Ur, Ur, Ur^Es, Ur, Ur, Uh, Uu, Xu, Uu, Uu, Ur, Uu, Ur, Ur, Ur, Uh, Ur^Esa, Aa^Esa, Ur^Esa, Ur, Ur, Ur, Ur, Ur, Ur, Uu, Uu, Uu, Ur, Ur, Ur, Ur, Uu, Uu, Xu, Xu, Ur, Xu, Xu, Xu, Xu
Ur, Ur, Uu, Uu, Uu, Ur, Uu, Ur, Ur, Ur, Ur, Xuc, Xuc, Xu, Xu, Xu, Xu, Uu, Uu, Uu, Uu, Xu, Xu, Ur, Uu, Uu, Uu, Uu, Uu, Uu, Uu, Uu, Xu, Xu, Xu, Uu, Uu, Ur, Ur, Xu, Xu, Xu, Xu, Xu, Xu, Xu
Xu, Uu, Xuc, Uu, Xuc, Uu, Xu, Xuc, Xuc, Ur, Ur^Em, Ur, Ior, Uh, Uu, Xu, Xu, Xu, Xu, Uu, Xu, Xu, Xu, Xu, Uu, Ur, Ur, Xu, Xu, Uu, Uh, Xu, Xu, Xu, Xu, Uu, Ur^Em, Ur^Em, Ur^Em, Uh, Uu^Vu, Xu, Xu, Xu, Xu, Xu
Xu, Xu, Xu, Xuc, Xu, Xu, Xu, Xu, Xu, Uh, Uu, Ior, Ior, Ior^Em, Uu^Vu, Xu, Xu, Xu, Xu, Xu, Xu, Xu, Uh, Xuc, Uu, Ur, Uh, Xu, Xu, Xu, Xu, Uh, Uh, Xu, Uh, Ur^Em, Ur^Em, Uu^Em, Ur^Em, Uu, Uh^Em, Uh, Xu, Xu, Xu, Xu
Xu, Xu, Xu, Xu, Xu, Xu, Xu, Xu, Xu, Uh, Uh, Uh, Uh, Uh, Xu, Xu, Xu, Xu, Xu, Xu, Uu, Uu, Ur, Uu, Uu, Uu, Uu, Xuc, Uh, Xu, Uu^Vu, Xu, Uu, Uh, Uu, Uu, Urc^Em, Urc^Em, Urc, Urc^Em, Uh^Em, Uh^Tf, Xu, Xu, Xu, Xu
Mm^Xm, Xu, Xu, Xu, Xu, Xu, Xu, Xu, Xu, Xu, Xu, Xu, Xu, Xu, Xu, Xu, Xu, Xu, Xu, Xu, Uu^Esa, Ur, Uu, Ur, Uu, Ur, Ur, Uu, Ur, Uu, Uh, Uu, Ur, Ur^Es, Ur, Urc^Es, Urc, Urc^Es, Urc, Urc, Xu, Xu, Xu, Xu, Xu, Xu
Mm^Xm, Mm^Xm, Mm^Xm, Xu, Mm^Xm, Xu, Xu, Xu, Xu, Xu, Xu, Xu, Xu, Xu, Xu, Xu, Xu, Xu, Xu, Xuc, Aa^Aybl, Uu, Uu^Esa, Ur, Uh, Ur, Ur, Uu, Uu, Ur, Ur, Uu, Uu, Ur, Ur, Urc^Em, Ur, Urc, Xu, Xu, Xu, Xu, Xu, Xu, Xu, Xu
Mm^Xm, Mm^Xm, Mm^Xm, Mm^Xm, Mm^Xm, Mm^Xm, Mm^Xm, Mm^Xm, Mm^Xm, Xu, Xu, Xu, Xu, Xu, Xu, Xu, Xu, Xu, Xuc, Uu^Esa, Ur^Esa, Aa^Esa, Aa^Aybl, Xu, Xu, Xu, Xu, Uu, Xu, Uu, Uu, Uu, Xu, Xu, Xu, Ur, Xu, Xu, Xu, Xu, Xu, Xu, Xu, Xu, Xu, Xu
Mm, Mm, Mm, Mm^Xm, Mm^Xm, Mm^Xm, Mm^Xm, Mm^Xm, Mm^Xm, Mm^Xm, Mm^Xm, Mm^Xm, Mm^Xm, Xu, Xu, Xu, Xuc, Xuc, Uu, Uu, Ur, Ur^Es, Ur^Esa, Xuc, Xu, Xu, Xu, Xu, Xu, Xu, Xu, Xu, Xu, Xu, Xu, Xu, Xu, Xu, Xoa, Xoa, Xu, Xu, Xu, Xu, Xu, Xu
Mm, Mm, Mm, Mm, Mm, Mm, Mm, Mm^Xm, Mm, Mm, Mm, Mm, Mm^Xm, Mm^Xm, Mm^Xm, Mm^Xm, Uu, Rb, Rb^Es, Rb^Es, Ur, Ur^Em, Uu^Em, Uu, Xuc, Xu, Xu, Xu, Xu, Xu, Xu, Xu, Xu, Xu, Xu, Xu, Xoa, Xu, Ias, Uu, Uh, Xoa, Xoa, Xu, Xu, Xu
Mm, Mm, Mm, Mm, Mm, Mm, Mm, Mm, Mm, Mm, Mm, Mm, Mm, Mm^Xm, Mm, Mm^Xm, Re, Rb^Esd, Re^Es, Rb^Es, Rb, Rb^Em, Rb, Uu, Uu, Xuc, Xu, Xu, Xu, Xu, Xu, Xu, Xu, Xu, Xu, Xu, Uu^Eb, Ias, Ias, Ias, Uu, Ias, Uu^Eb, Xu, Xu, Xu
Mm, Mm, Hh, Mm, Mm, Mm, Hh, Hh, Gd, Hh, Hh, Hh, Gd, Hh, Gs^Fp, Gs^Fp, Gd, Re, Re, Re, Re^Em, Rb, Re, Rb^Em, Uu, Uu, Xuc, Xu, Xu, Xu, Xu, Xu, Xu, Xu, Xu, Xoa, Xoa, Ias, Ias, Ias, Ias, Ias, Ias, Xoa, Xu, Xu
Hh, Hh, Hh, Hh, Hh, Hh, Gs, Hh, Gd, Gd, Gd, Gd, Gd, Gd, Gd, Gs^Fp, Gd, Gd, Gd, Gd, Gd, Re, Gd, Re, Re, Uu, Xu, Xu, Xu, Xu, Mm^Xm, Mm^Xm, Mm^Xm, Xu, Xu, Xu, Xoa, Uu, Ias^Esa, Ias, Ias, Ias, Xoa, Xu, Xu, Xu
Gg, Hh, Gg, Hh, Gg, Gg, Gs^Fp, Gd, Gd, Gd, Gd, Gd, Gd^Eff, Gd, Gd^Gvs, Gd^Gvs, Gs^Gvs, Gd^Gvs, Gd, Gd^Edt, Gd, Gd, Gd, Gd, Mm, Mm^Xm, Mm^Xm, Mm^Xm, Mm^Xm, Mm^Xm, Mm^Xm, Mm^Xm, Mm^Xm, Mm^Xm, Xu, Xu, Xoa, Xoa, Aa^Aybl, Aa^Aybl, Aa^Aybl, Ias, Xoa, Xu, Xu, Xu
Gg, Gg, Gg, Gg, Gg, Gs^Fp, Gs^Fp, Gs, Gs, Gd, Gs^Eff, Gd^Eff, Gd, Gd^Gvs, Gd^Vhr, Gs^Gvs, Gd^Gvs, Gd^Edt, Gd^Edb, Gd^Edb, Gs, Gd, Gd, Hh, Mm, Mm, Mm, Mm, Mm, Mm^Xm, Mm, Mm^Xm, Mm^Xm, Mm^Xm, Mm^Xm, Xu, Mm^Xm, Aa^Esa, Rp^Es, Aa, Ias, Aa^Aybl, Aa^Aybl, Xu, Mm^Xm, Xu
Ds, Gd, Gg, Gs^Fp, Gg, Gs^Fp, Gs^Fp, Gg, Gs, Gs, Gs, Gs^Eff, Gs^Eff, Gd, Gs, Gd^Gvs, Gd, Gd, Gd, Gd^Edb, Gd, Gs, Gd, Hh, Hh, Mm, Gd^Vhr, Mm, Hh, Mm, Mm, Mm, Mm, Mm^Xm, Mm, Mm^Xm, Mm, Rp^Esa, Gd, Gd, Gd, Rp^Esa, Aa^Esa, Mm^Xm, Mm, Mm^Xm
Ww, Ds, Ds, Gg, Gg, Gg^Efm, Gg, Gd, Gd, Gs, Gs^Es, Gs, Gs^Esa, Gs^Eff, Gd, Gd, Gd^Esa, Gd, Gd^Edb, Gd, Gd^Edb, Gd, Aa^Fpa, Gs^Fp, Gd, Gd, Gd, Hh, Ha^Fpa, Ms, Ms, Mm, Mm, Mm, Mm, Mm, Mm, Mm, Gd, Ias, Rp, Gd, Mm, Mm, Mm, Mm
Ww, Ww, Ds, Gd, Gd, Gg, Gd, Gd, Ds, Gd, Gd^Esa, Aa, Aa^Aybl, Aa^Fpa, Aa, Gd, Aa, Gd, Gd, Gd, Gd, Gs^Esa, Aa, Aa^Fpa, Gd^Edb, Gd, Gd, Gd^Esa, Aa, Ha, Aa, Mm, Mm, Mm, Hh, Mm, Mm, Mm, Gd, Rp, Rp, Gd, Mm, Mm, Mm, Mm
Ww, Ww, Ww, Ds, Ds, Gd, Gd, Gd, Gd, Gd, Gd, Aa^Esa, Aa^Esa, Aa^Esa, Aa^Esa, Aa^Aybl, Aa^Esa, Gd^Eff, Gd^Eff, Gd, Gd, Gd^Gvs, Gd^Gvs, Gd^Edb, Gd^Edb, Gd^Edb, Gd, Gd, Gd^Esa, Aa, Gs, Gll^Feth, Hh, Hh, Hh, Hh^Esa, Ha, Chr, Gd, Gd, Gd, Mm, Mm, Mm, Mm, Mm
Ww, Ww, Ww, Ds, Ds, Ds, Ds, Ds, Ds, Ds, Ds, Gd, Gg^Esa, Gs, Gs^Es, Aa, Gs^Esa, Gd, Gd^Eff, Gd^Eff, Gs^Gvs, Gd^Gvs, Gd^Vhr, Gd^Gvs, Gs^Gvs, Gs^Gvs, Gs^Gvs, Gd^Gvs, Gs, Gs, Gs^Es, Gs, Gs, Gd, Gd^Fp, Hh^Fp, Ha^Fpa, Aa^Esa, Gd^Edb, Rp, Gd^Es, Mm, Mm, Mm, Mm^Xm, Mm^Xm
Wo, Ww, Ww, Ww, Ww, Ww, Ww, Ww, Ww, Ww, Ds, Ds, Gd, Gg, Gs, Gs, Gs, Gs^Eff, Gs^Eff, Gs, Gs^Gvs, Gs^Gvs, Gs^Gvs, Gs^Gvs, Gs, Gd^Gvs, Gd, Gs^Es, Gd, Gs, Gs, Gs^Gvs, Gs^Gvs, Gd, Gd, Gd^Fp, Gd^Edb, Gd^Edb, Gd^Edb, Gd^Edb, Gd, Gd, Hh, Mm^Xm, Mm^Xm, Mm^Xm
Wo, Wo, Ww, Ww, Ww, Ww, Ww, Ww, Ww, Ww, Ds, Ds, Gg, Gg, Gg, Gg, Gg, Gg, Gg, Gs, Gs^Eff, Gs, Gs, Gs, Gs^Fp, Gd, Gd, Gd, Gd^Edb, Gd^Edb, Gs^Gvs, Gd^Gvs, Gd^Fp, Gd^Fp, Hh^Fp, Gd, Hh^Edb, Gd^Edb, Gd^Edb, Gd, Gd, Gd, Mm, Mm, Mm, Mm^Xm
Ww, Ww, Ww, Ww, Ww, Ww, Ww, Ww, Ww, Ds, Gd, Gd, Gg, Gg, Rb, Gg, Gg, Gg^Es, Gg, Gg, Gs, Gs^Eff, Gs, Gs^Fp, Gs^Fp, Gs^Fp, Gs, Gd^Edb, Gd^Edb, Gd^Edb, Gs, Gd, Gd, Gd^Fp, Hh, Hhd^Vhhr, Hh, Gd^Edb, Gd, Gll^Fp, Gd^Fp, Gd, Mm, Mm, Mm, Mm
Wwr, Wwr, Wwr, Ww, Ww, Ww, Ww, Ds, Ds, Ds, Ds, Gg, Gg, Rb, Gg, Gg, Gg^Efm, Gg, Gg, Gg, Gg^Edb, Gs^Edb, Gs^Edb, Gs, Gs, Gs, Gs^Edb, Gd^Edb, Gd, Gd, Gs^Fp, Gd, Gs, Gd, Gd, Hh, Gs, Hh, Gd, Gd^Fp, Hh^Fp, Gd, Mm, Mm, Mm^Xm, Mm^Xm
Wwr, Wwr, Wwr, Ww, Ww, Ww, Ww, Ww, Ds, Ds, Ds, Gd, Gd, Gg, Gd, Gg, Rb, Gg, Ww, Gg, Gg^Edb, Gg^Edb, Gg^Edb, Gs^Edb, Gg, Gs^Edb, Gs^Edb, Gd^Edb, Gs^Eff, Gd^Fp, Gd^Fp, Gs, Gd, Gd^Fp, Gd, Gd, Gd, Gd, Gd, Hh, Hh, Hh, Mm, Mm, Mm, Mm
Ww, Wwr, Ww, Ww, Ww, Ww, Ww, Ww, Ww, Ds, Ds, Ds, Ds, Gd, Ds, Ds, Ww, Ww^Ewl, Ww^Ewf, Ww, Gg, Gg^Edb, Gg^Edb, Gg^Edb, Gg, Gll^Fp, Gs, Gs, Gs^Esa, Gs^Eff, Gs^Eff, Gd, Gd^Fp, Gd, Hh, Hh, Hh, Hh^Es, Mm, Mm, Mm, Mm, Mm, Mm, Mm^Xm, Mm
Ww, Ww, Ww, Ww, Ww, Ww, Ww, Ww, Ww, Ds, Ww, Ds, Ww, Ds, Ww, Ww, Ww^Ewl, Ww, Gg, Ww, Gg, Gg^Edb, Gg, Gg^Edb, Gg, Gg, Aa, Aa, Aa, Gs^Esa, Gs, Gd, Gd^Fp, Hh^Fp, Hh, Hh, Mm, Hh, Re^Es, Mm, Mm^Xm, Re^Es, Mm, Mm^Xm, Mm^Xm, Mm^Xm
Ww, Ww, Ww, Ww, Wo, Ww, Ww, Ww, Ww, Ww, Ww, Ww, Ww, Ww, Ww, Ww, Ww, Ww, Gg, Gg, Gg, Gg, Gg, Gg, Gg, Gs^Esa, Gg, Aa^Esa, Gs, Gs, Hh, Gd, Mm, Mm, Mm, Mm, Mm, Mm, Mm, Re^Es, Re, Re, Hh^Es, Mm^Xm, Mm^Xm, Mm^Xm
Wo, Wo, Wo, Wo, Wo, Ww, Ww, Ww, Wwr, Wwr, Wwr, Ww, Ds, Ds, Ds, Ds, Gg, Gg, Gs, Gg, Gs, Gg, Gd, Gs, Gs, Gg, Gg, Gs, Gs^Fp, Hh^Fp, Hh, Hh, Mm, Mm^Xm, Mm, Mm, Mm, Mm, Mm, Hh, Hh^Fp, Re^Es, Re^Es, Mm^Es, Mm, Mm
Wo, Wo, Wo, Wo, Wo, Ww, Ww, Ww, Ww, Wwr, Ww, Ww, Ds, Gd, Gg, Gd, Gg, Gg, Gg, Gg, Gd, Gd, Gd, Gd, Gs, Gs, Gs, Gg, Gs^Fp, Gs^Fp, Mm, Mm, Mm, Mm, Mm^Xm, Mm^Xm, Mm^Xm, Mm^Xm, Mm^Xm, Mm, Mm, Mm, Mm, Re, Re^Es, Mm
Ww, Wo, Wo, Wo, Wo, Wo, Ww, Wwr, Wwr, Ww, Ww, Ds, Gg, Gg, Gg, Gg, Gg, Gs, Gs, Gg, Gg, Gd, Gg, Gg, Gg, Gs, Gs, Gg, Gg, Mm, Mm, Mm, Mm, Mm, Mm^Xm, Mm^Xm, Mm^Xm, Mm^Xm, Mm^Xm, Mm^Xm, Mm, Mm, Gg, Mm, Rd, Rd
