border_size=1
usage=map

Aa          , Aa          , Aa          , Aa          , Aa          , Aa          , Aa          , Aa          , Aa          , Aa          , Aa          , Aa          , Aa^Fpa      , Aa^Fpa      , Aa^Fpa      , Aa^Fpa      , Aa^Fpa      , Ai          , Ai          , Ai          , Ai          , Ai          , Ai          , Ai          , Ai          , Aa          , Aa          , Aa          , Ai          , Ai          , Ai          , Ai          , Ai          , Ai          , Ai          , Ai          , Ai          , Ai          , Ai          , Ai          , Aa          , Aa          , Aa          , Aa          , Aa          , Aa          
Aa          , Aa          , Aa          , Aa          , Aa          , Aa          , Aa          , Aa          , Aa          , Aa          , Aa          , Aa          , Aa          , Aa^Fpa      , Ai          , Ai          , Ai          , Ai          , Ai          , Ai          , Ai          , Ai          , Ai          , Ai          , Ai          , Ai          , Aa          , Aa          , Ai          , Ai          , Ai          , Ai          , Ai          , Ai          , Ai          , Ai          , Ai          , Ai          , Ai          , Ai          , Ai          , Aa          , Aa          , Aa          , Aa          , Aa          
Aa          , Aa          , Ce          , Ce          , Ce          , Aa          , Ai          , Aa          , Aa          , Aa          , Ai          , Aa          , Ai          , Ai          , Ai          , Ai          , Ai          , Ai          , Ai          , Ai          , Ai          , Ai          , Ai          , Ai          , Ai          , Aa          , Aa^Vca      , Aa          , Ai          , Ai          , Ai          , Ai          , Ai          , Ai          , Ai          , Ai          , Ai          , Ai          , Ai          , Ai          , Ai          , Ai          , Ai          , Aa          , Aa          , Aa          
Aa          , Aa          , Ce          , 1 Ke        , Ce          , Aa          , Ai          , Ai          , Ai          , Ai          , Ai          , Ai          , Ai          , Ai          , Ai          , Ai          , Ai          , Ai          , Ai          , Ai          , Ai          , Ai          , Ai          , Ai          , Ai          , Ai^Bw/      , Ai          , Aa^Fpa      , Ai          , Ai          , Ai          , Ayb         , Ayb         , Ayb         , Ai          , Ai          , Ai          , Ai          , Ai          , Ai          , Ai          , Ai          , Ai          , Aa          , Aa          , Aa          
Aa          , Aa          , Aa          , Ce          , Aa          , Aa          , Ai          , Ai          , Ai          , Ai          , Ai          , Ai          , Ai          , Ai          , Ai          , Ayb         , Ai          , Ai          , Ayb         , Ai          , Ai          , Ai          , Ai          , Ai          , Ai          , Ai          , Ai          , Ai          , Ai          , Ai          , Ai          , Ayb         , Ayb         , Ayb         , Ai          , Ai          , Ai          , Ai          , Ai          , Ai          , Ai          , Ai          , Ai          , Aa          , Aa          , Aa          
Aa          , Aa          , Aa          , Aa          , Ai^Bw\      , Ai          , Ai          , Ai          , Ai          , Ai          , Ai          , Ai          , Ayb         , Ayb         , Ayb         , Ayb         , Ai          , Ai          , Ayb         , Ai          , Ai          , Ai          , Ai          , Ai          , Ai          , Ai          , Ai          , Ayb         , Ayb         , Ai          , Ayb         , Ayb         , Ai          , Ai          , Ai          , Ai          , Ai          , Ai          , Ai          , Ai          , Ai          , Ai          , Ai          , Aa          , Aa          , Aa          
Aa          , Aa          , Aa          , Ai          , Ai          , Ai^Bw\      , Ai          , Ai          , Ai          , Ai          , Ai          , Ai          , Ai          , Ai          , Ai          , Ai          , Ai          , Ai          , Ayb         , Ai          , Ai          , Ai          , Ai          , Ai          , Ai          , Ai          , Ai          , Ai          , Ai          , Ayb         , Ai          , Ai          , Ai          , Ai          , Ai          , Ai          , Ai          , Ai          , Ai          , Ai          , Ai          , Ai          , Ai          , Ai          , Ai          , Ai          
Aa          , Aa          , Ai          , Ai          , Ai          , Ai          , Ai          , Ai          , Ai          , Ai          , Ai          , Ai          , Ai          , Ai          , Ai          , Ai          , Ai          , Ai          , Ayb         , Ayb         , Ai          , Ai          , Ai          , Ai          , Ai          , Ai          , Aa^Fpa      , Ai          , Ai          , Ai          , Ai          , Ai          , Ai          , Ai          , Ai          , Ai          , Ayb         , Ai          , Ai          , Ai          , Ai          , Ai          , Ai          , Ai          , Ai          , Ai          
Aa          , Aa          , Ai          , Ai          , Ai          , Ai          , Ai          , Ai          , Ai          , Ai          , Aa          , Ai          , Aa^Fpa      , Ai          , Ai          , Ai          , Ai          , Ai          , Ai          , Ayb         , Ai          , Ai          , Ai          , Ai          , Ai          , Aa^Fpa      , Aa          , Ha^Fpa      , Ha          , Ai          , Ai          , Ai          , Ai          , Ai          , Ai          , Ai          , Ayb         , Ayb         , Ai          , Ai          , Ai          , Ai          , Ai          , Ai          , Ai          , Ai          
Aa^Fpa      , Aa          , Ai          , Ai          , Ai          , Ai          , Ai          , Ai          , Ai          , Aa          , Aa          , Aa^Fpa      , Aa^Fpa      , Aa^Fpa      , Aa^Fpa      , Ai          , Ai          , Ai          , Ai          , Ai          , Ai          , Ai          , Ai          , Ai          , Ai          , Aa          , Aa          , Ha^Fpa      , Ha          , Ai          , Ai          , Ai          , Ayb         , Ayb         , Ai          , Ayb         , Ai          , Ayb         , Ai          , Ai          , Ai          , Ai          , Ai          , Ai          , Ai          , Ai          
Aa^Fpa      , Aa          , Ai          , Ai          , Ayb         , Ayb         , Ai          , Ai          , Ai          , Aa          , Aa          , Ha          , Aa          , Aa^Fpa      , Aa^Fpa      , Aa^Fpa      , Aa^Fpa      , Ai          , Ai          , Ai          , Ai          , Ai          , Ai          , Ai          , Ai          , Ai          , Ha          , Ha          , Ai          , Ai          , Ai          , Ai          , Ai          , Ayb         , Ai          , Ayb         , Ayb         , Ai          , Ai          , Ai          , Ai          , Ai          , Ai          , Ai          , Ai          , Ai          
Aa^Fpa      , Aa          , Ai          , Ai          , Ai          , Ayb         , Ai          , Ai          , Ai          , Ai          , Aa^Fpa      , Aa          , Ha          , Ha^Fma      , Ha          , Ha^Fma      , Aa          , Ai          , Ai          , Ai          , Ai          , Ai          , Ai          , Ai          , Ai          , Ai          , Ai          , Ai          , Ai          , Ai          , Ai          , Ai          , Ai          , Ai          , Ai          , Ayb         , Ayb         , Ai          , Ai          , Ai          , Ai          , Ai          , Ai          , Ai          , Ai          , Ai          
Aa^Fpa      , Aa          , Aa          , Ai          , Ai          , Ai          , Ai          , Ai          , Ai          , Ai          , Aa^Fpa      , Aa^Fpa      , Aa^Fpa      , Ha^Fpa      , Ha          , Ha          , Aa          , Ai          , Ai          , Ai          , Ai          , Ai          , Ai          , Ai          , Ai          , Ai          , Ai          , Ai          , Ai          , Ai          , Ai          , Ai          , Ai          , Ai          , Ai          , Ai          , Ayb         , Ai          , Ai          , Ai          , Ai          , Ai          , Ai          , Ai          , Ai          , Ai          
Aa^Fpa      , Aa          , Aa          , Ai          , Ai          , Ai          , Ai          , Ai          , Ai          , Ai          , Ai          , Aa^Fpa      , Aa^Fpa      , Aa^Fpa      , Aa          , Aa          , Ai          , Ai          , Ayb         , Ayb         , Ai          , Ai          , Wo          , Ww          , Ww          , Ai          , Ai          , Ai          , Ai          , Ai          , Ai          , Ai          , Ai          , Ai          , Ai          , Ai          , Ai          , Ayb         , Ai          , Ai          , Ayb         , Ai          , Ai          , Ai          , Ai          , Ai          
Aa^Fpa      , Aa^Fpa      , Ai          , Ai          , Ai          , Ai          , Ai          , Ai          , Ai          , Ai          , Ai          , Ai          , Ai          , Aa          , Ai^Bw\      , Ai          , Ai          , Ai          , Ai          , Ayb         , Ai          , Ai          , Ai          , Ww          , Ai          , Ai          , Ai          , Ai          , Ww          , Ai          , Ai          , Ai          , Ai          , Ai          , Ai          , Ai          , Ayb         , Ayb         , Ai          , Ayb         , Ayb         , Ai          , Ai          , Ai          , Ai          , Ai          
Aa^Fpa      , Aa^Fpa      , Ai          , Ai          , Ai          , Ai          , Ai          , Ai          , Ayb         , Ai          , Ai          , Ai          , Ai          , Ai          , Aa          , Aa          , Aa          , Ai          , Ai          , Ayb         , Ai          , Ai          , Ai          , Ai          , Ai          , Ai          , Ww          , Ww          , Cydy        , Ww          , Ww          , Ai          , Ai          , Ai          , Ai          , Ai          , Ayb         , Ayb         , Ai          , Ai          , Ayb         , Ayb         , Ai          , Ai          , Ai          , Ai          
Aa^Fpa      , Aa          , Ai          , Ai          , Ai          , Ai          , Ai          , Ai          , Ai          , Ayb         , Ai          , Ai          , Ai          , Aa          , Ha          , Aa^Vca      , Aa          , Ai          , Ai          , Ai          , Ai          , Ai          , Ai          , Ai          , Ai          , Wo          , Ww          , Cydy        , 2 Kydy      , Cydy        , Ww          , Ai          , Ai          , Ai          , Ai          , Ai          , Ayb         , Ayb         , Ai          , Ayb         , Ayb         , Ayb         , Ai          , Ai          , Ai          , Ai          
Aa^Fpa      , Aa          , Ai          , Ai          , Ai          , Ai          , Ai          , Ai          , Ai          , Ai          , Ai          , Ai          , Ai          , Aa          , Aa          , Ha          , Aa          , Ai          , Ai          , Ai          , Ww          , Ai          , Ai          , Ai          , Ai          , Wo          , Ww          , Cydy        , Cydy        , Cydy        , Ww          , Ai          , Ai          , Ai          , Ai          , Ai          , Ai          , Ayb         , Ai          , Ayb         , Ayb         , Ayb         , Ai          , Ai          , Ai          , Ai          
Aa          , Aa          , Ai          , Ai          , Ai          , Ai          , Ai          , Ai          , Ai          , Ai          , Ai          , Ai          , Ai          , Ai          , Ai          , Aa          , Ai          , Ai          , Ai          , Wo          , Ww          , Ww          , Ai          , Ai          , Ai          , Ai          , Ai          , Ww          , Ww          , Ww          , Ai          , Ai          , Ai          , Ai          , Ai          , Ai          , Ai          , Ai          , Ai          , Ayb         , Ayb         , Ai          , Ai          , Ai          , Ai          , Ai          
Ai          , Ai          , Ai          , Ai          , Ai          , Ai          , Ai          , Ai          , Ayb         , Ai          , Ayb         , Ai          , Ayb         , Ayb         , Ai          , Ai          , Ai          , Ai          , Ai          , Ai          , Ai          , Ai          , Ai          , Ai          , Aa          , Aa          , Aa          , Aa^Fma      , Aa          , Aa          , Aa          , Ai          , Ai          , Ai          , Ai          , Ai          , Ai          , Ai          , Ai          , Ayb         , Ayb         , Ai          , Ai          , Ai          , Ai          , Ai          
Ai          , Ai          , Ai          , Ai          , Ai          , Ai          , Ayb         , Ayb         , Ayb         , Ayb         , Ai          , Ayb         , Ai          , Ai          , Ai          , Ai          , Ai          , Ai          , Ai          , Ai          , Wo          , Ai          , Ai          , Ai          , Aa          , Aa^Fma      , Aa          , Aa          , Aa          , Aa          , Aa          , Aa          , Ai          , Ai          , Ai          , Ai          , Ai          , Ai          , Ai          , Ai          , Ai          , Ai          , Ai          , Ai          , Ai          , Ai          
Ai          , Ai          , Ai          , Ai          , Ayb         , Ayb         , Ayb         , Ayb         , Ayb         , Ai          , Ai          , Ai          , Ai          , Ai          , Ai          , Ww          , Ww          , Ai          , Ai          , Wo          , Ww          , Ww          , Ww          , Aa          , Aa          , Aa^Fma      , Aa          , Aa          , Aa          , Aa          , Aa          , Aa          , Aa          , Ai          , Ai          , Ai          , Ai          , Ai          , Ai          , Ai          , Ai          , Ai          , Ai          , Ai          , Ai          , Ai          
Ai          , Ai          , Ai          , Ai          , Ai          , Ai          , Ai          , Ayb         , Ayb         , Ayb         , Ayb         , Ai          , Ayb         , Ai          , Ai          , Ww          , Ai          , Ai          , Ai          , Ww          , Ww          , Cydy        , Kydy        , Ww          , Aa          , Aa          , Aa          , Aa          , Aa          , Aa^Fpa      , Aa^Fpa      , Aa          , Aa          , Aa          , Aa          , Ai          , Ai          , Ai          , Ai          , Ai          , Ai          , Ai          , Ai          , Ai          , Ai          , Ai          
Ai          , Ai          , Ai          , Ai          , Ai          , Ai          , Ai          , Ai          , Ai          , Ai          , Ayb         , Ayb         , Ayb         , Ai          , Ai          , Ai          , Ai          , Ai          , Wo          , Wo          , Ww          , Cydy        , Ww          , Kydy        , Aa          , Ha          , Aa^Fma      , Aa          , Ai          , Aa^Fpa      , Aa^Fpa      , Aa^Fpa      , Aa          , Aa          , Aa          , Ai          , Ai          , Ai          , Ai          , Ai          , Ai          , Ai          , Ai          , Ai          , Ai          , Ai          
Ai          , Ai          , Ai          , Ai          , Ai          , Ai          , Ai          , Ai          , Ai          , Ai          , Ai          , Ai          , Ai          , Ayb         , Ayb         , Ai          , Ai          , Ai          , Ai          , Wo          , Ai          , Ww          , Ai          , Aa          , Aa          , Aa          , Ai          , Ai          , Ai          , Ai          , Ai          , Aa          , Aa          , Aa          , Aa          , Ai          , Ai          , Ai          , Ai          , Ai          , Ai          , Ai          , Ai          , Ai          , Ai          , Ai          
Ai          , Ai          , Ai          , Ai          , Ai          , Ai          , Aa^Fpa      , Aa^Fpa      , Aa          , Ai          , Ai          , Ai          , Ai          , Ai          , Ai          , Ai          , Ai          , Ai          , Ai          , Ai          , Ai          , Ai          , Ai          , Ai          , Ai          , Ai          , Ai          , Ai          , Ai          , Ai          , Ai          , Ai          , Aa          , Aa          , Aa          , Ai          , Ai          , Ai          , Ai          , Ai          , Ai          , Ai          , Ai          , Ai          , Ai          , Ai          
Ai          , Ai          , Ai          , Ai          , Ai          , Ai          , Aa          , Aa^Fpa      , Aa          , Ai          , Ai          , Ai          , Ai          , Ai          , Ai          , Ai          , Ai          , Ai          , Ai          , Ai          , Aa          , Ai          , Ai^Bw/      , Ai          , Ai          , Ai          , Ai          , Ayb         , Ai          , Ai          , Ai          , Ai          , Aa          , Aa          , Aa^Vca      , Ai          , Ai          , Ai          , Ai          , Ai          , Ai          , Ai          , Ai          , Ai          , Ai          , Ai          
Ai          , Ai          , Ai          , Ai          , Ai          , Ai          , Ai          , Aa^Vca      , Ai          , Ai          , Ai          , Ai          , Ai          , Ai          , Ai          , Ai          , Ai          , Ai          , Aa          , Aa          , Aa^Fpa      , Aa          , Ai          , Ai          , Ai          , Ai          , Ayb         , Ayb         , Ai          , Ai          , Ai          , Ai          , Aa          , Aa          , Ai          , Ai          , Ai          , Ai          , Ai          , Ai          , Ayb         , Ai          , Ai          , Ai          , Ai          , Ai          
Ai          , Ai          , Ai          , Ai          , Ai          , Ai          , Ai          , Ai          , Ai          , Ai          , Ai          , Ai          , Ai          , Ai          , Ai          , Ai          , Ai          , Ai          , Ai^Bw/      , Chr         , Aa          , Aa          , Ai          , Ai          , Ayb         , Ayb         , Ai          , Ai          , Ai          , Ai          , Aa          , Aa          , Aa^Fma      , Aa          , Ai          , Ai          , Ai          , Ai          , Ayb         , Ayb         , Ayb         , Ai          , Ai          , Ai          , Aa          , Aa          
Ai          , Ai          , Ai          , Ai          , Ai          , Ai          , Ai          , Ai          , Ai          , Ai          , Ai          , Ai          , Ayb         , Ai          , Ayb         , Ai          , Ai          , Ai          , Ai          , Ai          , Ai          , Ai          , Ai          , Ai          , Ayb         , Ai          , Ai          , Ai          , Ai          , Aa^Fma      , Aa^Fma      , Aa^Fma      , Ai          , Ai          , Ai          , Ai          , Ayb         , Ai          , Ayb         , Ai          , Ai          , Ai          , Ai          , Aa          , Aa          , Aa          
Ai          , Ai          , Ai          , Ai          , Ai          , Ai          , Ai          , Ai          , Ai          , Ai          , Ai          , Ai          , Ayb         , Ayb         , Ayb         , Ai          , Ai          , Ai          , Ai          , Ai          , Ai          , Ai          , Ai          , Ayb         , Ayb         , Ai          , Ai          , Ai          , Ai          , Ai          , Ai          , Ai          , Ai          , Ai          , Ai          , Ayb         , Ayb         , Ayb         , Ai          , Ai          , Ai          , Ai          , Ai          , Aa^Fpa      , Aa          , Aa          
Aa          , Aa          , Aa          , Ai          , Ai          , Ai          , Ai          , Ai          , Ai          , Ai          , Ai          , Ai          , Ai          , Ayb         , Ayb         , Ai          , Ai          , Ai          , Ai          , Ai          , Ai          , Ai          , Ayb         , Ayb         , Ayb         , Ai          , Ai          , Ai          , Ai          , Ai          , Ai          , Ai          , Ai          , Ai          , Ai          , Ayb         , Ai          , Ai          , Ai          , Ai          , Ai          , Ai          , Ai          , Aa          , Aa          , Aa          
Aa          , Aa          , Aa          , Aa          , Ai          , Ai          , Ai          , Ai          , Ai          , Ai          , Ai          , Ai          , Ai          , Ai          , Ai          , Ayb         , Ai          , Ai          , Ai          , Ai          , Ai          , Ai          , Ai          , Ai          , Ayb         , Ayb         , Ayb         , Ai          , Ai          , Ai          , Ayb         , Ai          , Ayb         , Ai          , Ai          , Ai          , Ai          , Ai          , Ai          , Ai          , Ai          , Ai          , Aa^Cov      , Aa^Cov      , Aa^Cov      , Aa          
Aa          , Aa          , Aa          , Aa          , Aa          , Aa          , Aa          , Ai          , Ai          , Ai          , Ai          , Ai          , Ai          , Ai          , Ai          , Ai          , Ai          , Ai          , Ai          , Ai          , Ai          , Ai          , Ai          , Ai          , Ai          , Ayb         , Ayb         , Ayb         , Ayb         , Ayb         , Ayb         , Ayb         , Ai          , Ai          , Ai          , Ai          , Ai          , Ai          , Aa          , Aa^Fpa      , Aa          , Aa          , Aa^Cov      , 4 Aa^Kov    , Aa^Cov      , Aa          
Aa          , Aa          , Aa          , Aa          , Aa          , Aa          , Aa          , Aa          , Ai          , Ai          , Ai          , Ai          , Ai          , Ai          , Ai          , Ai          , Ai          , Ai          , Ai          , Ai          , Ai          , Ai          , Ai          , Ai          , Ai          , Ai          , Ayb         , Ayb         , Ai          , Ayb         , Ayb         , Ai          , Ai          , Ai          , Ai          , Ai          , Ai          , Aa          , Aa          , Aa          , Aa          , Aa          , Aa          , Aa          , Aa          , Aa          
