Xos, Xos, Xos, Xos, Xos, Xos, Xos, Xos, Xos, Xos, Xos, Xos, Xos, Xos
Xos, Xos, Urfz, Urfz, Urfz, Urfz, Urfz, Xos, Ce, Ce, Xos, Xos, Xos, Xos
Xos, Xos, Urfz, Urfz, Ce, Ce, Ce, Ce, Xos, Xos, Xos, Xos, Xos, Xos
Xos, Urfz, Urfz, Urfz, Xos, Xos, Xos, Xos, Xos, Xos, Urfz^Edb, Xos, Xos, Xos
Xos, Urfz, Urfz, Xos, Ds, Ds, Ds, Xos, Urfz^Edb, Urfz^Edb, Urfz^Edb, Urfz^Edb, Xos, Xos
Xos, Urfz, Urfz, Xos, Ds, Ds, Ds, Xos, Urfz^Edb, Urfz^Edb, Urfz^Edb, Xos, Xos, Xos
Xos, Urfz, Urfz, Xos, Xos, Ds, Rrc, Rrc^Bryl, Rrc, Urfz^Edb, Urfz^Edb, Urfz^Edb, Xos, Xos
Xos, Urfz, Urfz, Urfz, Urfz, Rrc^Bryl, Rrc, Rrc, Rrc, Rrc, Rrc, Urfz, Xos, Xos
Xos, Xos, Xos, Urfz, Urfz, Rrc, Rrc, Rrc, Rrc, Rrc, Rrc, Urfz, Xos, Xos
Xos, Xos, Xu, Xu, Xu, Urfz, Cuay, Rrc, Urfz, Rrc, Xu, Xu, Xu, Xos
Xu, Xu, Cuay, Xu, Urfz, Cuay, Urfz, Kuay, Cuay, Xu, Xu, Xu, Xu, Xos
Xu, Xu, Cuay, Cuay, Urfz, Urfz, Urfz, Urfz, Cuay, Cuay, Xu, Xu, Xu, Xos
Xu, Xu, Xu, Xu, Xu, Urfz^Bryl, Xu, Xu, Xu, Xu, Xu, Xu, Xu, Xos
Xu, Xu, Xu, Xu, Xu, Xu, Xu, Xu, Xu, Xu, Xos, Xu, Xos, Xos
