Mm^Xm, Mm^Xm, Xu, Xu, Xu, Xu, Xu, Xu, Xu, Uu, Ur, Ur, Uu^Hsry, Uh, Uh, Hh, Xu, Xu, Xu, Xu, Xu, Xu, Mm^Xm, Mm, Mm^Xm, Mm^Xm
Mm, Mm^Xm, Mm^Xm, Xu, Mm^Xm, Xu, Xu, Xu, Xu, Xu, Xuc, Ur^Esa, Ur^Esa, Ur, Uu, Uh, Xu, Xu, Xu, Xu, Xu, Xu, Mm^Xm, Mm^Xm, Mm, Mm^Xm
Mm, Mm, Mm, Mm^Xm, Mm^Xm, Mm^Xm, Mm^Xm, Mm^Xm, Mm^Xm, Xu, Xu, Aa, Aa^Aybl, Ur^Esa, Aa^Aybl, Xuc, Xuc, Xu, Xu, Xu, Xu, Mm^Xm, Mm, Mm, Mm, Mm
Mm^Xm, Mm, Mm^Xm, Mm^Xm, Mm, Mm, Mm, Mm, Xu, Xu, Xuc, Aa^Aybl, Ha, Aa^Aybl, Re, Aa, Rb, Xu, Xu, Xu, Mm^Xm, Mm^Xm, Mm^Xm, Mm, Mm, Mm
Mm^Xm, Mm^Xm, Mm^Xm, Mm^Xm, Mm, Mm, Mm, Mm^Xm, Mm^Xm, Xu, Uhe, Uue^Esa, Uue^Esa, Uue^Esa, Re^Em, Re^Es, Uhe, Xuc^Hsry, Mm, Mm, Mm, Mm^Xm, Mm^Xm, Mm^Xm, Mm, Mm
Mm^Xm, Mm^Xm, Mm^Xm, Mm^Xm, Mm, Mm, Mm, Mm, Mm, Mm^Xm, Hh, Hh^Esa, Re, Re, Re, Rb, Hh, Mm, Mm, Mm, Mm, Mm, Mm, Mm, Mm, Mm
Mm^Xm, Mm^Xm, Mm^Xm, Mm^Xm, Mm, Hh, Hh, Mm, Hh, Hh, Gg, Rb, Re^Es, Re, Hh, Hh, Hh, Hh, Hh, Mm, Mm, Mm, Mm, Mm, Mm, Mm
Hh, Mm, Hh^Fp, Mm, Mm, Mm, Hh, Hh, Hh, Gg, Gg, Rb, Gg, Gg, Hh, Hh, Hh, Hh, Mm, Hh, Mm, Mm, Mm, Mm, Mm^Xm, Mm
Hh, Hh, Hh, Hh, Hh, Hh, Hh, Hh^Fp, Hh, Gg, Gg, Gg^Es, Gg, Hh, Hh, Hh, Hh, Mm, Mm, Mm, Mm, Hh, Hh, Mm^Xm, Mm^Xm, Mm^Xm
Mm, Mm, Mm, Hh, Hh, Hh, Hh, Hh, Mm, Hh, Hh, Gg, Gs, Gg, Gg, Gg, Hh^Fp, Mm, Mm, Mm, Hh, Hh, Hh^Fp, Hh, Mm, Mm^Xm
Mm, Mm, Hh, Hh, Gs, Gg, Hh, Hh, Mm, Mm, Mm, Hh, Gs, Gs, Gs, Hh, Gg, Hh, Hh, Gg, Hh, Hh, Hh^Fp, Hh, Hh, Mm
Mm, Mm, Hh^Fp, Gs, Gg^Fp, Hh, Hh, Hh, Hh^Fp, Mm, Hh, Hh, Gs, Gs, Gg, Gg, Hh, Gg, Gg, Gg, Gs, Hh^Fp, Hh^Fp, Hh, Hh, Mm
Mm, Mm^Fp, Hh^Fp, Hh^Fp, Gg, Gg, Gg, Gg^Fp, Hh, Hh, Hh, Hh, Hh, 1 Gg, Gg, Hh, Gg^Fp, Gg^Fp, Hh, Gs, Gd, Gs^Fp, Gs, Hh, Hh, Hh
Hh, Hh, Hh^Fp, Hh, Hh, Hh, Gg, Gg, Gs, Gg, Hh, Hh, Gg, Gg, Hh, Gg^Fp, Gg^Fp, Gg^Fp, Gg, Hh, Gs, Gd^Es, Gs, Hh^Fp, Hh, Hh
Hh, Hh, Hh, Hh^Fp, Hh, Hh, Hh, Gs, Gs^Es, Gs, Gg, Gg, Hh, Gg, Gg, Hh^Fp, Gg, Hh^Fp, Hh, Gs, Gs, Gs, Hh, Gg, Hh, Hh
Gll^Fp, Gll^Fp, Hh, Hh, Hh, Gg, Gg, Gs, Gs, Gs, Hh^Fp, Hh, Gg, Re, Re, Gg, Gs, Gg, Gs, Gg, Gg, Hh, Mm, Hh, Mm, Hh
