Xu, Xu, Xu, Xu, Uh^Ii, Aa, Uu^Ii, Aa, Xu, Xu, Xu, Xu, Xu, Xu, Xu, Xu, Xu, Xu, Xu, Xu, Xu, Xu, Xu, Xu, Xu, Xu, Xu, Xu, Xu, Xu, Xu, Xu, Xu, Xu, Xu, Xu, Xu, Xu, Xu, Xu, Xu, Xu, Xu, Xu, Xu, Xu, Xu, Xu, Xu, Xu, Xu, Xu, Xu, Xu, Xu, Xu, Xu, Xu, Xu, Xu, Xu, Xu, Xu^Qhh, Xu^Qhh, Wwg^Qhh, Wwg^Qhh, Wwg^Qhh
Xu, Xu, Xu, Xu, Xu, Uh^Ii, Uu^Ii, Uh^Ii, Xu, Xu, Xu, Xu, Xu, Xu, Xu, Xu, Xu, Xu, Xu, Xu, Xu, Xu, Xu, Xu, Xu, Xu, Xu, Xu, Xu, Xu, Xu, Xu, Xu, Xu, Xu, Xu, Xu, Xu, Xu, Xu, Xu, Xu, Xu, Xu, Xu, Xu, Xu, Xu, Xu, Xu, Xu, Xu, Xu, Xu, Xu, Xu, Xu, Xu, Xu, Xu, Xu, Xu, Xu^Qhh, Xu, Wwg, Wwg, Wog^Qhh
Xu, Xu, Xu, Xu, Xu, Xu, Xu, Uu^Ii, Ur, Xu, Uu, Xu, Uu, Xu, Uu, Xu, Uu, Xu, Uu, Uu^Tf, Tb^Tf, Xu, Xu, Xu, Xu, Xu, Xu, Xu, Xu, Xu, Xu, Xu, Xu, Xu, Xu, Xu, Xu, Xu, Xu, Xu, Xu, Xu, Xu, Xu, Xu, Xu, Xu, Xu, Xu, Xu, Xu, Xu, Uu, Uu, 1 Uu, Uu, Uu, Uu, Uu^Edt, Uu^Qhh, Ds^Qhh, Ds^Qhh, Wwg^Qhh, Wwg, Wog^_mh, Wog, Wog^Qhh
Xu, Xu, Xu, Xu, Xu, Xu, Xu, Xu, Uu, Ur, Uu, Uu, Uu, Uu, Uu^Hsry, Uu, Uu, Uu, Uu, Uu, Uu, Uu^Tf, Xu, Xu, Xu, Xu, Xu, Xu, Xu, Xu, Xu, Xu, Xu, Xu, Xu, Xu, Xu, Xu, Xu, Xu, Xu, Xu, Xu, Xu, Xu, Xu, Xu, Xu, Xu, Xu, Xu, Re^Vct, Uu, Uu, Ur, Uu, Uu, Uu, Uu^Edt, Ds^Edt, Ds, Wwg, Wwg, Wwg^Qhh, Wog^Qhh, Wog, Wog^Qhh
Xu, Xu, Xu, Xu, Tb^Tf, Tb^Tf, Uu^Tf, Uu, Ur, Uu, Uu, Uu, Uu, Uu, Uu, Uu, Uu, Uu, Ds, Uu, Uu, Uu, Uu, Xu, Xu, Xu, Xu, Xu, Xu, Xu, Xu, Xu, Xu, Xu, Xu, Xu, Xu, Xu, Xu, Xu, Xu, Xu, Xu, Xu, Xu, Xu, Xu, Xu, Xu, Xu, Uu^Edt, Uu^Edt, Uu^Edt, Uu, Uu, Uu, Uu, Uu, Ds, Ds, Wwg, Wwg, Wwg, Wog^Qhh, Wog, Wog^Qhh, Wog^Qhh
Xu^Qhu, Xu^Qhu, Tb^Qhu, Tb^Tf, Tb^Tf, Tb^Tf, Uu, Uu, Uu, Ur, Ds, Ds, Ds, Uu, Ds, Uu, Ds, Ds, Ds, Ds, Ds, Uu, Ds, Uu, Ds, Xu, Xu, Xu, Xu, Xu, Xu, Xu, Xu, Xu, Xu, Xu, Xu, Xu, Xu, Xu, Xu, Xu, Xu, Xu, Xu, Xu, Xu, Xu, Xu, Xu, Uu^Edt, Uu^Edt, Ur, Uu, Uu, Uu, Ds, Ds, Ds, Wwrg, Wwrg, Wwrg, Wwg, Wog, Wog, Wog^Qhh, Wog^Qhh
Xu^Qhu, Xu, Tb^Tf, Uu^Qhu, Uu^Qhu, Uu, Ds, Ds, Ds, Ds, Wwg, Wwg, Wwg, Ds, Wwg, Ds, Ds, Ds, Wwg, Wwrg, Wwg, Ds, Wwg, Ds, Wwg, Ds, Wwg, Xu, Wog, Xu, Xu, Xu, Xu, Xu, Xu, Xu, Xu, Xu, Xu, Xu, Xu, Xu, Xu, Xu, Xu, Xu, Xu, Xu, Uu, Uu, Uu, Uu^Edt, Ur, Uu^Es, Uu, Uu, Ds, Wwrg, Wwrg, Wwrg, Wwg, Wwg, Wog, Wog, Wog, Wog, Wog^Qhh
Qxu^Qhu, Tb^Tf, Uu, Uu, Uu, Ds^Qhu, Ds, Ds, Wwg, Wwg, Wwf, Wwg, Wwf, Wwf, Wwg, Wwg, Wwg, Wwg, Wwg, Wog, Wog, Wwg, Wog, Wwg, Wog, Wwg, Wog, Wog, Wog, Wog, Wog, Wog, Wog, Xu, Xu, Xu, Xu, Xu, Xu, Xu, Xu, Xu, Uu, Uu^Em, Uu, Uu^Em, Uu, Uu, Uu, Uu, Ur^Es, Ur, Uu, Uu, Uu, Ds, Wwrg, Wwg, Wwrg, Wwrg, Wwg, Wwg, Wog, Wog, Wog, Wog, Wog^Qhh
Qxu^Qhu, Qxu, Qxu, Uu, Ds, Ds^Qhu, Wwrg^Qhu, Wwg, Wwg, Wwf, Wwf, Wwf, Wwf, Wwf, Wwg, Wwg, Wwg, Wwg, Ds, Wwg, Wwg, Wog, Wwg, Wog, Wwg, Wog, Wwg, Wog, Wwg, Wog, Wog, Wog, Wog, Wog, Wog, Wwrg, Wwrg, Xu, Xu, Xu, Ds, Uu, Uu, Uu, Uu, Uu^Dr, Uu, Ur, Ur, Uu^Es, Uu, Ur, Ur, Uu, Uu, Ds, Ds, Wwg, Wwg, Wwrg, Wwg, Wog, Wog, Wog, Wog, Wog^Qhh, Wog^Qhh
Qxu^Qhu, Qxu^Qhu, Qxu, Wwrg, Wwg, Wwrg, Wwg, Wwg^Qhu, Wwg, Wwf, Ds, Ds, Ds, Ds^Edt, Ds^Edt, Wwg, Ds^Edt, Ds, Uu^Hsry, Ds, Ds, Wwg, Uu^Hsry, Wwg, Ds, Wwg, Ds, Wwg, Ds, Wwg, Wwg, Wog, Wog, Wog, Wwrg, Wwrg, Wwg^Hsry, Xu, Wwrg, Ds, Ds, Uu, Uu, Uu, Uu, Uu, Ur, Uu, Ur, Uu, Xu, Uu, Ds, Ds, Ds, Ds, Wwg, Wwg, Wwg, Wwg, Wog, Wog, Wog, Wog, Wog, Wog^Qhh, Wog^Qhh
Qxu^Qhu, Qxu, Qxu, Wwf, Wwg, Wwg, Wwg, Wwg^Qhu, Ds^Qhu, Ds, Uu, Ur, Ur, Uu^Edt, Uu^Edt, Ds^Edt, Uu^Es, Uu^Es, Uu^Dr, Uu^Es, Uu^Dr, Xu, Xu, Uu^Hsry, Uu, Ds, Uu, Ds, Uu, Ds, Ds, Ds, Tb^Tf, Wog, Wwrg, Wwg^Hsry, Wwg^Hsry, Wwg^Hsry, Wwg^Hsry, Wwrg, Wwrg, Ds, Ds, Ds, Ds, Ds, Ds, Ds, Ds, Xu, Xu, Xu, Wog, Wwg, Wwg, Wwg, Wwg, Wwg, Wog, Wog, Wog, Wog, Wog, Wog, Wog, Wog, Wog
Qxu^Qhu, Qxu, Qxu, Qxu, Qxu, Wwrg, Ds, Ds, Uu^Qhu, Uu, Tb, Tb^Tf, Uu, Ur, Uu, Uu, Uu, Uu^Es, Uu^Es, Uu^Es, Uu^Es, Uu^Hsry, Xu, Xu, Uu, Uu, Uu, Uu, Uu, Uu, Tb^Tf, Tb^Tf, Wwg, Wog, Wwrg, Wwg^Hsry, Wwg^Hsry, Wwg^Hsry, Wwg^Hsry, Wwg^Hsry, Wwg^Hsry, Wwrg, Wwrg, Wwg, Wwg, Wwrg, Wwg, Wwg, Wwg, Xu, Xu, Wog, Wog, Wog, Wog, Wog, Wog, Wog, Wog, Wog, Wog, Wog, Wog, Wog, Wog, Wog, Wog
Qxu^Qhu, Qxu, Qxu^_ml, Qxu, Qxu, Qxu, Uu, Uu, Uu^Qhu, Uu, Tb, Uu, Ur, Ur, Uu, Ur, Ur, Uu^Dr, Uu, Uu, Uu, Uu^Es, Uu, Tb^Tf, Uu, Uu, Ur, Uu, Uu, Uu, Ds, Wwg, Wog, Wog, Wwg, Wwrg, Wwg^Hsry, Wwg^Hsry, Wwg^Hsry, Wwg^Hsry, Wwrg, Wwg, Wog, Wog, Wog, Wwg, Wog, Wwg, Wwf, Wwg, Wwg, Wog, Wwg, Wwg, Wwg, Wog, Wog, Wog, Wog, Wog, Wog, Wog, Wog, Wog, Wog, Wog, Wog
Qxu^Qhu, Qxu, Qxu, Qxu, Qxu, Uu, Uu, Tb^Tf, Tb^Qhu, Ur, Tb^Tf, Tb^Tf, Tb^Tf, Uu, Uu, Uu, Uu, Ur, Ur, Uu, Uu, Uu, Ds^Es, Uu, Uu, Ur, Uu^Dr, Ur, Ur, Ds, Wwg, Wog, Wog, Wog, Ds, Wwg, Ds, Wwrg, Wwg^Hsry, Wwg^Hsry, Wog, Wog, Wog, Wog, Wog, Wog, Wwg, Wwg, Wwf, Wwg, Wwg, Wog, Wog, Wwrg, Wog, Wog, Wog, Wog, Wog, Wog, Wog, Wog, Wog, Wog, Wog, Wog, Wog
Qxu^Qhu, Qxu, Qxu, Qxu, Wwrg, Uu, Uu, Uu^Qhu, Uu, Uu, Uu, Uu^Es, Uu, Uu, Xu, Uu^Hsry, Uu^Hsry, Ur, Ur, Uu, Ds, Ds, Wwg, Ds, Ds, Uu, Uu, Uu, Ds^Es, Ds, Wwg, Wog, Wwg, Wwg, Ds, Ds, Ds, Wwrg, Wwrg, Wwg, Ds, Wwrg, Wwg, Wog, Wog, Wwg, Uu, Wwrg, Wwg, Wwg, Wwf, Wwg, Wwg, Wog, Wog, Wog, Wog, Wog, Wog, Wwg, Wog, Wog, Wog, Wog, Wog, Wog, Wog
Qxu^Qhu, Qxu, Qxu, Wwg, Wwg, Ds, Ds, Ds^Qhu, Ds, Ds, Ds, Ds^Es, Ds, Uu^Es, Uu^Hsry, Xu, Uu^Hsry, Ds^Es, Ds, Ds, Wwg, Wwg, Wog, Wwg, Wwrg, Uu, Ds, Ds, Ds, Ds, Wog, Wog, Wwg, Ds, Uu, Uu, Xu, Wwg^Hsry, Xu, Ds, Wwg, Wwg, Wog, Wog, Wog, Wwg, Wwg, Wwrg, Wwg, Wwg, Ds, Ds, Wwg, Wwrg, Wog, Wog, Wog, Wog, Wog, Wog, Wog, Wog, Wog, Wog, Wog, Wog, Wwg
Qxu^Qhu, Qxu, Qxu, Wwg, Wwf, Wwg, Wwg, Wwg^Qhu, Wwg^Qhu, Wwg, Wwg, Ds, Wwg, Ds^Es, Wwg, Uu^Hsry, Wwg, Wwg, Wwg, Wwg, Wwg, Wog, Wwg, Wwg, Ds, Ds, Wwg, Wwrg, Wwg^Hsry, Wwrg, Wwrg, Wwg, Wwg, Uu^Tf, Ur, Ur, Xu, Xu, Xu, Wwg, Wwg, Wog, Wwg, Wwg, Wwg, Wog, Uh, Uu, Wwg, Ds, Ds, Wwrg, Wwg, Wwg, Wog, Wog, Wog, Wog, Wog, Wog, Wwg, Wog, Wwg, Wwg, Wwg, Wwg, Wwg
Qxu^Qhu, Qxu, Wwg, Wwrg, Wwf, Wwrg, Wwg, Wwg, Wog^Qhu, Wwg, Wog, Wwg, Wog, Wwg, Wog, Wwg, Wwg^Qhu, Wwg, Wwrg, Wwg, Wog^Qhu, Wog^Qhu, Wwg, Ds, Wwg, Wwg, Wog, Wog, Wwrg, Ds, Ds, Wwg, Sm, Uu, Ur, Uu, Ds, Xu, Ds, Wwg, Wwrg, Wog, Wwrg, Ds, Wwrg, Wwg, Wwrg, Wwrg, Ds, Ds, Wwg, Wwg, Wog, Wog, Wog, Wog, Wog, Wog, Wwg, Wwg, Wwg, Wwg, Wwrg, Wwg, Wwrg, Wwrg, Xu
Qxu^Qhu, Qxu, Qxu, Wwg, Wwg, Wwg, Wwg, Wwf, Wog, Wog^Qhu, Wog, Wog, Wwrg, Wog, Wog, Wog^Qhu, Wog, Wwg^Qhu, Wwg^Qhu, Wwg^Qhu, Wwg^Qhu, Wog^Qhu, Wog^Qhu, Wwg, Wog^Qhu, Wog^Qhu, Wwg, Wwg, Ds, Ds, Wwg, Wwf, Sm^Em, Uu^Tf, Tb^Tf, Uu, Ds, Ds, Wwg, Ds, Ds, Wwg^Hsry, Wog, Wwg, Wwrg, Wwrg, Wwrg, Ds, Ds, Wwrg, Wwg, Wwg, Wog, Wog, Wog, Wog, Wog, Wwg, Wwrg, Wwrg, Ds, Ds, Ds, Wwrg, Wwrg, Xu, Xu
Qxu^Qhu, Qxu, Qxu, Qxu, Wwrg, Wog, Wog, Wwg, Wwf, Wog^Qhu, Wog^Qhu, Wog, Wog, Wwg, Wog^Qhu, Wog^Qhu, Wog, Wwf, Wwf, Ds, Wwg, Wog^Qhu, Wwrg, Wog^Qhu, Wwg, Wwg, Ds, Ds, Ds, Wwrg, Wwrg, Wwg, Sm^Em, Uu^Em, Uu^Em, Ds, Wwrg, Wwg, Wwg, Wwg, Ds, Wwrg, Wwf, Wwg, Wwg, Wwg, Ds, Ds, Ds, Wwg, Wog, Wog, Wog, Wog, Wog, Wog, Wog, Wwg, Wwrg, Ds, Uu, Uu, Ds, Wwrg, Wwrg, Xu, Xu
Qxu^Qhu, Qxu, Qxu, Qxu, Wwrg, Wog, Wog, Wwg, Wwf, Wwg, Wog, Wog^Qhu, Wog^Qhu, Wog^Qhu, Wog, Wog, Wog, Wwrg, Wog, Wwf, Wwf, Wwrg, Ds, Wwg^Qhu, Ds, Ds, Ds, Tb^Tf, Ds, Wwrg, Wwg, Sm, Sm^Em, Uu^Tf, Uu^Tf, Wwrg, Wwrg, Wwg, Wwg, Wwg, Wwrg, Wwg, Wwf, Wwg, Ds, Ds, Uu, Ur, Ds, Wwg, Wog, Wog, Wog, Wog, Wog, Wog, Wog, Wwg, Wwrg, Ds, Ds, Ds, Wwg, Wwg, Wwg, Xu, Xu
Qxu^Qhu, Qxu, Wwg, Wwg, Wwrg, Wwrg, Wwg, Wwf, Wwg, Wwrg, Wwg, Wog, Wwg, Wwg, Wwg, Wwg, Wwg, Wog, Wog, Wog, Wog, Wwf, Wwg, Wwg^Qhu, Wwg^Qhu, Wwg, Wwg, Ds, Wwg, Wwg, Wwf, Sm, Wwf, Uu^Tf, Wwg, Uu, Ds, Ds, Ds, Ds, Wwg, Wog, Wwg, Ds, Uu, Uu^Hsry, Ur, Uu, Ds^Edt, Wwg, Wwg, Wwrg, Wog, Wog, Wog, Wog, Wog, Wwg, Wwg, Wwrg, Wwg, Wwg, Wwrg, Wwrg, Wwrg, Wwrg, Xu
Qxu^Qhu, Qxu, Wwrg, Wwrg, Wwrg, Wwg, Wwg, Wwg, Wwg, Wwg, Wwg, Wwg, Ds, Ds, Ds, Ds, Wwg, Wwg, Wog^Qhu, Wog, Wog, Wog, Wwg, Wog, Wog, Wog^Qhu, Wog^Qhu, Wog^Qhu, Wog^Qhu, Wog, Wog, Sm, Wog, Wwg, Wwf, Wwg, Wwg, Wwrg, Wwg, Wwg, Wog, Wog, Wwg, Ds, Uu, Ur, Uu^Dr, Uu, Ds^Edt, Wwrg, Wwg, Wwg, Xu, Wwrg, Wwrg, Wog, Wwg, Wwg, Wwg, Wwg, Rb, Wwrg, Sm, Wwrg, Wwrg, Xu, Xu
Qxu^Qhu, Qxu, Uu, Ds, Ds, Ds, Ds, Ds, Ds, Ds, Ds, Ds, Uu^Edt, Ds^Edt, Wwg, Wwg, Wog^Qhu, Wog^Qhu, Wwrg, Wwg^Qhu, Wwg^Qhu, Wwg^Qhu, Wwg^Qhu, Wwrg^Qhu, Wwrg^Qhu, Wwg^Qhu, Xu, Wwg, Wwg, Wwg, Wwg, Wog, Wwg, Wwg, Wog, Wwg, Wog, Wog, Wog, Wog, Wwrg, Wwg, Ds, Ds, Uu, Uu, Uu, Uu, Ds^Edt, Ds^Edt, Ds^Edt, Xu, Xu, Xu, Xu, Wwg, Wwg, Wwg, Rb, Sm, Sm, Sm, Rb, Sm, Xu, Xu, Xu
Qxu^Qhu, Uu, Uu, Uu, Tb^Tf, Uu, Uu, Ur, Ur^Es, Uu, Uu^Qhu, Uu, Uu, Ds^Edt, Wwg, Wog, Wog^Qhu, Wwg^Hsry, Wwg^Hsry, Ds^Es, Ds^Es, Ds, Ds^Es, Ds, Ds, Uu^Hsry, Xu, Xu, Ds, Ds, Ds, Wwg, Ds, Wwg, Wwg, Wog, Wwg, Wwg, Wwg, Wwg, Wwrg, Wwrg, Uu, Uu, Uu, Ur, Rb^Es, Uu, Uu^Edt, Ds^Edt, Ds, Xu, Xu, Xu, Xu, Uu, Uu, Uu, Uu, Uu, Uu, Sm, Uu, Rb, Xu, Xu, Xu
Qxu^Qhu, Qxu, Qxu, Uu, Tb, Tb^Tf, Tb^Tf, Uu, Uu^Qhu, Uu^Qhu, Tb^Tf, Uu^Qhu, Uu^Qhu, Ds^Edt, Ds^Edt, Wwg, Wwg, Wog^Qhu, Wwg^Hsry, Ds^Es, Ds, Uu^Es, Uu, Uu, Uu, Xu, Xu, Uu^Hsry, Uu, Uu, Uu, Ds, Uu, Ds, Wwg, Wog, Wwg, Wwg, Wwrg, Wwrg, Uu, Uu, Ur, Uu^Em, Rb^Es, Sm, Rb, Uu, Uu, Uu, Uu, Uu, Uu, Xu, Uu, Uu, Uu, Uu, Uu, Uu, Uu^Edb, Uu, Uu^Edb, Xu, Xu, Xu, Xu
Qxu^Qhu, Qxu, Qxu, Uu, Uu, Tb^Tf, Tb, Uu^Qhu, Uu, Tb^Tf, Tb^Tf, Tb^Tf, Tb^Qhu, Uu^Edt, Uu^Edt, Ds^Edt, Wwg, Wog^Qhu, Wog^Qhu, Wwg^Hsry, Wwrg, Ds^Bw/r, Ds^Edt, Ur, Ur^Es, Uu^Tf, Ur^Em, Uu^Dr, Ur^Em, Ur, Uu, Uu, Ds, Ds, Wwg, Wog, Wwg, Ds, Ds, Wwrg, Uu, Ur, Ur, Rb^Es, Rb^Es, Rb, Rb^Em, Rb^Em, Ur, Uu, Uu^Es, Uu, Uh, Uu, Uu, Uu, Uu^Hsry, Uu, Uu, Uu, Uu^Edb, Uu^Edb, Uu^Edb, Xu, Xu, Xu, Xu
Qxu^Qhu, Qxu, Qxu, Uu, Uu, Uu, Ur^Hsry, Uu^Qhu, Uu^Hsry, Xu, Xu, Tb^Tf, Tb^Tf, Uu^Qhu, Uu^Qhu, Ds^Edt, Ds, Wwg, Wwrg, Wog^Qhu, Wog^Qhu, Wwg, Wwrg, Ds, Ds, Uu, Uu, Uu^Tf, Uu^Em, Ur, Ds, Ds, Wwrg, Wwg, Wwg, Wog, Wwg, Ds, Uu, Uu, Uu^Es, Ur^Es, Uu^Es, Uu, Uu, Ur^Es, Uu, Ur^Em, Uu, Ur, Ur, Uu, Uh, Uh, Uu, Uu, Uu^Em, Uu, Uu, Uh, Uu^Edb, Uu^Edb, Uu^Edb, Uu^Edb, Xu, Xu, Xu
Qxu^Qhu, Qxu, Qxu, Qxu, Uu, Uu, Uu^Dr, Uu^Qhu, Xu, Xu, Uu^Hsry, Tb^Tf, Tb^Tf, Uu, Uu, Uu^Qhu, Uu^Qhu, Ds, Ds, Wwg^Hsry, Wog^Qhu, Wwg^Hsry, Wwrg^Qhu, Ds^Es, Ds^Es, Ds, Ds, Uu, Ds, Ds, Wwg, Wwg, Wwrg, Wwrg, Wwrg, Wwg, Ds, Ds, Uu, Uu, Ur^Es, Uu^Dr, Uu^Es, Uu^Hsry, Uu, Uu^Em, Xu, Tb^Tf, Xu, Uu, Uu, Uu, Xu, Uu, Uu, Uu^Em, Uu^Em, Uu^Em, Uu, Uu^Edb, Uu^Edb, Uu^Edb, Uu^Edb, Xu, Xu, Xu, Xu
Qxu^Qhu, Qxu, Qxu, Uu, Tb, Tb^Tf, Tb^Qhu, Uu^Qhu, Uu, Xu, Uu, Tb^Tf, Uu, Uu, Ur^Es, Uu, Uu^Qhu, Uu^Edt, Ds^Edt, Wwrg, Wwrg, Wog^Qhu, Wog, Wwrg^Qhu, Wwg^Qhu, Wwg, Wwg, Ds, Ds^Es, Wwrg, Wwg, Wwg, Wwg, Wwg, Ds, Ds, Uu, Uu, Ur^Es, Ur, Ur, Uu^Es, Uu^Hsry, Uu, Xu, Xu, Xu, Xu, Xu, Xu, Xu, Ur, Uu, Uu, Uu, Uu, Xu, Uu, Uu, Uu, Uu, Uu^Edb, Uu^Edb, Xu, Xu, Xu, Xu
Qxu^Qhu, Qxu, Qxu, Uu, Uu, Tb^Tf, Tb^Qhu, Uu, Uu^Vu, Uu, Ur, Uu, Uu, Uu, Ur, Uu, Uu^Qhu, Uu^Edt, Uu^Edt, Ds^Es, Ds^Dr, Wwg^Hsry, Wwg^Hsry, Wog, Wog, Wwg^Qhu, Wwg^Qhu, Wwrg^Qhu, Ds^Qhu, Wwg, Wwg, Wwrg, Wwg, Wwg, Ds, Uu, Uu, Uu, Uu, Uu, Uu, Uu^Hsry, Xu, Xu, Xu, Xu, Xu, Xu, Xu, Xu, Xu, Uu, Uu, Ur, Uu^Hsry, Xu, Xu, Xu, Xu, Uu, Xu, Xu, Xu, Xu, Xu, Xu, Xu
Qxu^Qhu, Qxu, Qxu, Qxu, Uu^Hsry, Tb, Ur^Qhu, Uu^Qhu, Uu, Ur, Uu, Uu, Uu, Ur, Ur^Qhu, Uu^Qhu, Uu^Dr, Uu, Uu, Uu, Ds^Es, Ds^Es, Wwrg, Wwrg, Wwg, Wog, Wog, Wog, Wog, Wwg^Qhu, Wwrg, Wwg, Ds^Es, Ds, Uu, Uu, Uu^Hsry, Uu^Dr, Ur, Uu, Uu^Tf, Tb^Tf, Xu, Xu, Xu, Xu, Xu, Xu, Xu, Xu, Tb^Tf, Uh, Uh, Ur, Uu, Xu, Xu, Xu, Xu, Xu, Xu, Xu, Xu, Xu, Xu, Xu, Xu
Qxu^Qhu, Qxu, Qxu, Uu, Uu^Dr, Uu, Ur^Qhu, Uu, Uu^Hsry, Uu^Hsry, Xu, Uu, Ur^Qhu, Uu^Qhu, Uu, Uu, Uu, Uu, Ds, Uu, Ds^Es, Wwrg, Wwg, Wwg, Wwg, Wog, Wog, Wog, Wwg^Qhu, Wwg^Qhu, Wwg, Wwg, Ds, Uu^Es, Uu, Uu, Uu, Uu^Es, Ur, Uu^Em, Uu, Uu^Tf, Uu^Em, Xu, Xu, Xu, Xu, Xu, Xu, Tb^Tf, Uu^Tf, Uu, Rb, Uh, Uu, Uu, Uu, Xu, Xu, Xu, Uu, Xu, Xu, Xu, Xu, Xu, Xu
Qxu^Qhu, Qxu, Uu, Uu, Ds, Uu, Uu, Uu^Qhu, Xu^Qhu, Xu^Qhu, Xu^Qhu, Uu^Qhu, Uu, Uu, Ds, Ds, Ds, Ds, Wwg, Ds, Wwg, Wwg, Wwg, Wwg, Wog, Wog, Wwrg^Qhu, Wwg^Qhu, Wwg, Wwg, Ds, Ds, Uu, Uu, Uh, Uh, Uh, Uu, Uu, Ur, Ur^Es, Uu^Em, Uu, Uu^Tf, Tb^Tf, Xu, Xu, Xu, Uu^Tf, Uu^Tf, Uu, Rb, Ur^Em, Ur, Uu, Uu, Uu, Xu, Rb, Uu, Ur, Ur, Uu, Xu, Xu, Xu, Xu
Qxu^Qhu, Qxu, Qxu, Wwrg, Ds, Ds, Ds, Ds, Ds^Dr, Uu^Hsry, Ds, Uu, Ds, Ds, Wwrg, Wwg, Wwg, Wwg, Wwg, Wwg, Wog, Wog, Wog, Wog, Wwg^Qhu, Wwg^Qhu, Wwg, Wwg, Ds, Ds, Uu, Uu, Uu, Uu, Uh, Uh, Uh, Uh, Ur, Uu^Es, Uu, Uu, Ur, Tb^Tf, Ur, Uh, Uu, Uu^Tf, Uu, Uu, Uu, Rb, Rb^Em, Rb^Em, Uu, Uu^Dr, Uu, Rb, Xu, Ur, Ur, Uu, Xu, Xu, Xu, Xu, Xu
Qxu^Qhu, Qxu, Qxu, Wwf, Wwg, Ds, Wwrg, Ds, Wwg, Ds, Wwg, Ds, Wwg, Ds, Wwrg, Wwrg, Wog, Wwg, Wog, Wog, Wwrg, Wog, Wog^Qhu, Wwg^Qhu, Wwrg, Wwg, Ds, Ds, Uu, Uu, Uu, Uu, Uu, Uu, Uu, Uh, Uu, Uu, Uu, Uu, Uu, Uu, Tb^Tf, Ur^Em, Uu, Uh, Ur, Uu, Ur, Uh, Uu, Ur, Ur, Uu, Uu^Vct, Uu, Rb, Xu, Xu, Xu, Xu, Xu, Xu, Xu, Xu, Xu, Xu
Qxu^Qhu, Qxu, Qxu, Qxu, Qxu, Wwg, Wwrg, Wwg, Wwg, Wwg, Wog, Wwg, Wog, Wwg, Wog, Wog, Wog, Wog, Wog, Wog, Wog^Qhu, Wog^Qhu, Wwg, Wwg, Wwrg, Wwrg, Uu, Uu, Uu, Uu^Em, Uu^Tf, Uu^Tf, Uu^Tf, Uu^Em, Uu, Uu, Uu, Uu, Xu, Uu, Xu, Xu, Xu, Uu^Tf, Uu, Uu, Uu, Uu, Uu, Uh, Uu, Uu, Rb, Rb, Uh, Uh, Uh, Uu^Vct, Xu, Xu, Xu, Xu, Xu, Xu, Xu, Xu, Xu
Qxu^Qhu, Qxu, Qxu, Qxu, Qxu, Wwrg, Wwrg, Wwrg, Wwg, Wog, Wog, Wog, Wog, Wog, Wog, Wog, Wog, Wog, Wog^Qhu, Wog^Qhu, Wwg, Wwg^Qhu, Ds, Ds, Uu, Uu, Uu, Uu, Tb^Tf, Uu^Tf, Tb^Tf, Uu^Tf, Uu, Uu^Em, Uu, Uu, Xu, Xu, Xu, Xu, Xu, Xu, Xu, Uu^Tf, Uu, Uu, Xu, Uu, Uu, Uu^Hsry, Uu, Uu^Vct, Uh, Uh, Ql, Qlf, Qlf, Xu, Xu, Xu, Xu, Xu, Xu, Xu, Xu, Xu, Xu
Qxu^Qhu, Qxu, Qxu, Qxu, Qxu, Qxu, Qxu, Wwrg, Xu, Wwrg, Xu, Wog, Xu, Xu, Xu, Wog, Wog, Wog^Qhu, Wog^Qhu, Wwg, Ds, Ds^Qhu, Uu, Uu, Uu, Uu, Uu, Uu, Uu, Uu, Xu, Uu, Xu, Uu, Xu, Xu, Xu, Xu, Xu, Xu, Xu, Xu, Xu, Xu, Xu, Xu, Xu, Xu, Xu, Uu, Uu, Uh, Uh, Ql, Ql, Qlf, Ql, Qlf, Qlf, Xu, Xu, Xu, Xu, Xu, Xu, Xu, Xu
Qxu^Qhu, Qxu^Qhu, Qxu, Qxu, Qxu, Qxu, Qxu, Xu, Xu, Xu, Xu, Xu, Xu, Xu, Xu, Xu, Xu^Qhu, Wog^Qhu, Xu, Xu, Xu, Xu^Qhu, Xu, Xu, Xu, Xu, Xu, Uu, Xu, Xu, Xu, Xu, Xu, Xu, Xu, Xu, Xu, Xu, Xu, Xu, Xu, Xu, Xu, Xu, Xu, Xu, Xu, Xu, Xu, Xu, Xu, Uh, Xu, Qlf, Ql, Ql, Xu, Xu, Qlf, Xu, Xu, Xu, Qlf, Xu, Xu, Xu, Xu
Qxu^Qhu, Qxu^Qhu, Qxu, Qxu, Qxu, Qxu, Qxu, Qxu, Qxu, Xu, Xu, Xu, Xu, Xu, Xu, Xu, Xu^Qhu, Xu, Xu, Xu, Xu, Xu^Qhu, Xu, Xu, Xu, Xu, Xu, Xu, Xu, Xu, Xu, Xu, Xu, Xu, Xu, Xu, Xu, Xu, Xu, Xu, Xu, Xu, Xu, Xu, Xu, Xu, Xu, Xu, Xu, Xu, Xu, Uu, Uu, Xu, Xu, Xu, Xu, Xu, Xu, Qlf, Qlf, Qlf, Xu, Xu, Xu, Xu, Xu
Qxu^Qhu, Qxu^Qhu, Qxu^Qhu, Qxu^Qhu, Qxu^Qhu, Qxu^Qhu, Qxu^Qhu, Qxu^Qhu, Qxu^Qhu, Xu^Qhu, Xu^Qhu, Xu^Qhu, Xu^Qhu, Xu^Qhu, Xu^Qhu, Xu^Qhu, Xu^Qhu, Xu, Xu, Xu, Xu, Xu^Qhu, Xu, Xu, Xu, Xu, Xu, Xu, Xu, Xu, Xu, Xu, Xu, Xu, Xu, Xu, Xu, Xu, Xu, Xu, Xu, Xu, Xu, Xu, Xu, Xu, Xu, Xu, Xu, Xu, Xu, Xu, Qxu, Qxu, Xu, Xu, Xu, Xu, Xu, Xu, Xu, Qlf, Qlf, Xu, Xu, Xu, Xu
