Xos, Xos, Xos, Xos, Xos, Xos, Xos, Xos, Xos, Xos, Xos, Xos, Xos, Xos, Xos, Xos, Xos, Xos, Xos, Xos, Xos, Xos, Xos, Xos, Xos, Xos, Xos, Xos, Xoc, Xoc, Xoc, Xos, Xos, Xos, Xoc, Xos, Xos, Xos, Xoc, Xos, Xos, Xos, Xos, Xos, Xos, Xos
Xos, Xos, Xos, Xos, Rrc^Yfra, Xos, Rra^Yfra, Rrc^Yfra, Rra^Yfra, Rrc^Yfra, Rra^Yfra, Rrc^Yfra, Rrc^Yfra, Xos, Xos, Xos, Xos, Xos, Rrc, Xos, Xos, Xos, Rrc, Xos, Xos, Xos, Xoc^Enfy, Xoc, Isr, Isr, Isr, Xoc, Xoc, Xoc, Isr, Xoc, Xoc^Enfy, Xoc, Isr, Xoc, Xoc^Enfy, Xos, Xos, Xos, Xos, Xos
Xos, Xos, Rrc^Yfra, Rrc^Yfra, Rrc^Yfro, Rrc^Yfra, Rra^Yfra, Rra^Yfra, Ai^Yfro, Rra^Yfra, Ai^Yfro, Rra^Yfra, Rra^Yfra, Rrc, Rrc, Xos, Rrc, Rrc, Rrc, Xos, Xos, Rrc, Rrc, Rrc, Rrc, Rrc, Isr, Isr, Isr, Isr, Isc, Isc^Bryu, 2 Isc^Kov, Isc^Bryu, Isc, Isr, Isr, Isr, Isr^Ii, Isr, Isr, Rrc, Rrc, Xos, Xos, Xos
Xos, Xos, Rrc^Yfra, Rrc^Yfra, Rra^Yfro, Rra^Yfro, Ai^Yfro, Ai^Yfro, Ai^Yfro, Ai^Yfro, Ai^Yfro, Rra^Yfra, Rra, Rrc, Rrc, Xos, Xos, Rrc, Rrc, Xos, Rrc^Pr\, Rrc, Rrc, Rrc, Rrc, Isr, Isr, Isr, Isr, Isc, Isc, Isc^Cov, Isc, Isc^Cov, Isc, Isc, Isr, Isr, Isr, Isr, Rrc, Rrc, Rrc, Rrc, Rrc, Xos
Xos, Rrc, Rrc, Rra^Yfra, Ai^Yfro, Ai^Yfro, Ai^Yfro, Ai^Yfro, Ai^Yfro, Ai^Yfro, Ai^Yfro, Ai^Yfro, Rra, Rrc, Rrc, Xos, Xos, Rrc, Rrc, Rrc, Xos, Xos, Rrc, Rrc, Rrc^Esd, Rrc, Rrc, Isr, Isr, Isr, Isr, Isc, Isc, Isc, Isr, Isr, Isr, Isr, Rrc, Rrc, Rrc, Rrc, Rrc, Rrc, Rrc, Xos
Xos, Rrc, Rra, Rra^Yfra, Rra, Ai^Yfro, Ai^Yfro, Ai^Yfro, Ai, Ai^Yfro, Ai^Yfro, Ai, Rra, Rra, Rrc, Rrc, Xos, Rrc, Rrc, Rrc, Rrc, Rrc^Pr\, Xos, Rrc, Rrc, Rrc, Rrc, Rrc, Rrc, Isr^Es, Isr, Isc, Isc^Es, Isc, Isr, Isr, Rrc, Rrc, Rrc, Rrc, Rrc, Rrc, Xos, Xos, Xos, Xos
Xos, Rrc, Rrc, Rra, Rrc, Rra, Rra, Ai, Rra, Ai, Ai, Ai, Rra, Rra, Rra, Rrc, Urb, Urb^Esa, Rra, Rr, Rrc, Rrc, Rrc, Xos, Rrc^Pr\, Rrc, Rrc, Rrc, Xos, Rrc, Rrc, Isc, Isc, Isc, Rrc, Rrc, Xos, Rrc, Rrc, Rrc, Rrc^Pr/, Xos, Rrc, Xos, Xos, Xos
Xos, Xos, Xos, Rrc, Xos, Rrc, Rrc, Rra, Rrc, Rra, Rra, Rra, Rra, Rrc, Rrc, Rrc, Xos, Urb, Rrc, Rrc, Rrc, Rrc, Rrc, Rrc, Rrc, Rrc^Pr\, Xos, Rrc, Xos, Rrc, Rrc, Rrc, Rrc, Rrc, Rrc, Rrc, Xos, Rrc, Xos, Rrc^Pr/, Rrc, Rrc, Rrc, Rrc, Xos, Xos
Xos, Xos, Xos, Xos, Xos, Xos, Xos, Rrc, Xos, Rrc, Urb, Rrc, Rrc, Rrc, Rra, Rrc, Urb, Xos, Rrc, Rrc, Rrc, Rrc, Rrc, Rrc^Es, Rrc, Rrc, Rrc, Xos, Xos, Rrc, Xos, Rrc, Xos, Rrc, Xos, Rrc, Xos, Xos, Rrc, Rrc, Rrc, Rrc, Rrc, Rrc, Xos, Xos
Xos, Xos, Xos, Xos, Xos, Xos, Xos, Xos, Xos, Xos, Urb, Urb, Urb, Rrc, Rrc, Rrc, Urb, Xos, Rrc, Rrc, Xos, Rrc, Rrc, Rrc, Rrc, Rrc, Rrc, Rrc, Xos, Xos, Xos, Rrc^Pr|o, Xos^Enfy, Rrc^Pr|o, Xos, Xos, Xos, Rrc, Rrc, Rrc, Rrc, Rrc, Rrc, Rrc, Rrc, Xos
Xos, Xos, Xos, Xos, Urb, Urb, Urb, Xos, Urb, Urb^Pr\, Xos, Xos, Xos, Rrc, Urb, Urb, Urb, Xos, Xos, Xos, Rrc, Rrc, Rr, Rr, Rr, Rrc, Rrc, Rrc, Xos, Xos, Rrc, Rrc, Rrc, Rrc, Rrc, Xos, Xos, Rrc, Rrc, Rrc, Rrc, Rrc^Esa, Rrc, Rrc, Rrc, Xos
Xos, Xos, Urb, Urb, Urb, Urb^Esd, Urb, Urb, Urb, Xos, Xos, Xos, Xos, Xos, Urb, Urb, Urb, Urb, Xos, Rrc, Rrc, Rr, Rr, Rr, Rrc, Rrc, Rrc, Rrc, Xos, Rrc, Rrc, Rrc, Rrc, Rrc, Rrc, Rrc, Xos, Rrc, Rrc, Rrc, Rrc, Rrc, Rrc, Rrc, Rrc, Xos
Xos, Xos, Urb, Urb, Urb, Urb, Urb, Urb, Urb, Urb, Urb, Xos, Xos, Xos, Xos, Urb, Urb, Urb, Xos, Rrc, Xos, Rrc, Rrc, Rrc, Rrc, Rrc, Rrc^Pr/, Rrc^Pr/o, Rrc, Rrc, Rrc, Rrc, Rrc^Es, Rrc, Rrc, Rrc, Rrc, Rrc^Pr\o, Rrc^Pr\, Rrc, Rrc, Rrc, Rrc, Rrc, Rrc, Xos
Xos, Xos, Urb, Urb, Urb^Pr/, Xos, Xos, Urb, Urb, Urb, Urb, Urb, Urb, Xos, Xos, Xos, Xos, Xos, Xos, Xos, Xos, Xos, Xos, Xos, Xos, Xos, Xos, Rrc, Rrc, Rrc, Rr, Rr, Rrc, Rrc, Rrc, Rrc, Rrc, Rrc, Xos, Xos, Rrc, Rrc, Rrc, Rrc, Xos, Xos
Xos, Xos, Xos, Xos, Urb, Urb, Urb, Xos, Xos, Urb, Urb, Urb, Urb, Urb, Urb, Xos, Xos, Xos, Xos, Xos, Xos, Xos, Xos, Xos, Xos, Xos, Xos, Xos, Rrc, Rrc, Rrc, Rr, Rrc, Rrc, Xos, Rrc, Xos, Xos, Xos, Xos, Rrc, Rrc, Rrc, Rrc, Xos, Xos
Xos, Xos, Urb, Urb, Urb^Esd, Urb, Urb, Urb, Urb, Xos, Xos, Xos, Urb^Pr\, Urb, Urb, Urb, Urb^Pr/, Xos, Urb, Xos, Iwo, Xos, Xos, Xos, Iwo, Xos, Xos, Xos, Xos, Rrc, Xos, Rrc, Xos, Xos, Xos, Xos, Xos, Xos, Iwr, Xos, Xos, Xos, Xos, Xos, Xos, Xos
Xos, Xos, Urb, Urb, Urb, Urb, Urb, Urb, Xos, Xos, Urb, Urb, Urb, Xos, Xos, Urb^Pr/, Urb, Urb, Iwo, Iwo, Iwo, Iwo, Iwo, Iwo, Iwo, Iwo, Iwo, Iwo, Xos, Rrc^Pr|o, Xos^Enfy, Rrc^Pr|, Xos, Iwo, Iwo, Iwo, Rb, Iwr, Rb, Iwo, Rb, Xos, Iwo, Xos, Xos, Xos
Xos, Xos, Xos, Urb, Urb, Urb, Xos, Xos, Urb, Urb, Urb, Urb, Urb, Urb, Xos, Xos, Iwo, Iwo, Iwo, Iwo, Iwr, Iwr, Iwr, Iwo, Iwr, Iwo, Iwo, Iwo, Iwo, Iwo, Iwo, Iwo, Iwo, Iwo, Rb, Rb, Rb, Rb, Xom, Rb, Rb, Rb, Rb, Iwo, Xos, Xos
Xos, Xos, Xos, Xos, Xos, Xos, Urb, Urb, Urb, Urb, Urb, Urb, Xos, Xos, Iwo, Iwo, Iwo, Iwo, Iwo, Iwo^Esa, Iwo, Iwr, Iwo, Iwr, Iwo, Iwr, Iwo, Iwo, Iwo, Iwo, Iwo, Iwo, Iwo, Iwo, Iwo, Rb, Rb, Xom, Xom, Xom, Rb, Rb, Rb, Rb, Xos, Xos
Xos, Xos, Xos, Xos, Xos, Xos, Xos, Urb, Xos, Urb, Urb, Urb, Xos, Iwo, Iwo, Iwo, Urb, Urb, Urb, Urb, Urb, Iwo, Iwo, Iwo, Iwo, Iwr, Iwr, Iwo, Iwr, Iwo, Iwr, Iwo, Iwr, Iwo, Iwo, Rb, Rb, Rb, Rb, Rb, Rb, Rb, Rb, Rb, Xos, Xos
Xos, Xos, Xos, Xos, Xos, Xos, Xos, Xos, Xos, Xos, Xos, Urb, Xos, Iwo, Iwo, Iwo, Urb^Esa, Urb, Urb, Urb, Urb, Urb, Urb, Urb, Iwr, Iwr, Iwo, Iwr, Iwo, Iwr, Iwr, Iwr, Iwr, Iwr, Xos, Iwo, Rb, Rb^Es, Rb, Rb, Rb, Rb, Iwr, Iwr, Xos, Xos
Ai, Xos, Xos, Xos, Ai, Xos, Xos, Xos, Xos, Xos, Xos, Xos, Xos, Iwo, Iwo, Urb, Urb, Urb, Aa, Urb^Esa, Aa, Urb, Urb, Urb^Esa, Urb, Iwo, Iwo, Iwo, Iwr, Iwr, Iwr, Iwr, Xos, Urb^Pr/, Urb, Xos, Xos, Rb, Xos, Xos, Urb^Pr|, Xos, Xos, Xos, Xos, Xos
Ai, Ai, Ai, Ai, Wog, Ai, Ai, Xos, Xos, Xos, Xos, Xos, Xos, Xos, Xos, Xos, Xos, Aa, Ai, Aa, Ai, Aa, Xos, Urb, Urb, Iwo, Xos, Iwo, Xos, Iwr, Xos, Xos, Xos, Urb, Urb, Urb, Xos, Xos, Xos, Xos, Urb, Xos, Xos, Xos, Xos, Xos
Ai, Ai, Ai, Ai, Ai, Wog, Ai, Ai, Ai, Ai, Aa^Fpa, Xos, Xos, Xos, Xos, Xos, Xos, Ss, Ss, Ss, Rb, Ai, Xos, Xos, Xos, Xos, Xos, Xos, Xos, Xos, Xos, Xos, Xos, Xos, Xos, Xos, Xos, Xos, Xos, Urb, Urb, Urb, Xos, Xos, Xos, Xos
Ai, Ai, Ai, Ai, Ai, Ai, Ai, Ai, Ai, Ai, Ai, Ai, Ai, Xos, Xos, Xos, Ai, Ss, Ss, Aa, Aa, Ai, Ai, Xos, Xos, Xos, Xos, Aa, Ai, Xos, Ai, Ai, Ai, Ai, Ai, Xos, Ai, Xos, Xos, Xos, Xos, Xos, Xos, Xos, Ai, Xos
Ai, Ai, Ai, Ai, Ai, Ai, Ai, Ai, Ai, Ai, Ai, Ai, Ai, Ai, Ai, Ai, Ai, Ai, Ai^Bw/r, Rp, Ai, Aa, Ai, Xos, Xos, Xos, Ai, Aa^Fpa, Ai, Ai, Ai, Ai, Ai, Ai, Ai, Ai, Ai, Ai, Ai, Xos, Xos, Xos, Ai, Ai, Ai, Ai
Ai, Ai, Ai, Ai, Ai, Ai, Ai, Ai, Ai, Ai, Ai, Ai, Ai, Ai, Aa, Ai, Wwf, Ss, Ai, Ai, Ss, Ai, Ai, Ai, Ai, Ai, Ai, Ai, Wog, Ai, Ai, Ai, Ai, Ai, Ai, Ai, Ai, Ai, Ai, Ai, Ai, Ai, Ai, Ai, Ai, Ai
Ai, Ai, Ai, Ai, Ai, Ai, Ai, Ai, Ai, Ai, Ai, Ai, Ai, Aa^Fpa, Aa, Rra, Ai, Wwf, Ss, Ai, Ai, Ai, Ss, Ai, Ai, Ai, Ai, Ai, Ai, Ai, Ai, Ai, Ai, Ai, Ai, Ai, Ai, Ai, Ai, Ai, Ai, Ai, Ai, Ai, Ai, Ai
Aa, Ai, Ai, Ai, Ai, Ai, Ai, Ai, Ai, Ai, Ai, Ai, Ai, Ai, Ai, Rra, Ai, Ss, Ai, Ss, Ss, Ss, Ai, Ai, Aa, Aa, Aa, Ai, Ai, Ai, Ai, Ai, Ai, Ai, Ai, Ai, Ai, Ai, Ai, Ai, Ai, Ai, Ai, Ai, Ai, Ai
Aa, Aa, Aa, Ai, Ai, Ai, Ai, Ai, Ai, Ai, Ai, Wog, Wog, Wwf, Ai, Ai, Ai, Ai, Aa, Ss, Ai, Ai, Ss, Aa^Fpa, Aa^Fpa, Aa^Vca, Aa, Ai, Ai, Ai, Ai, Ai, Ai, Ai, Ai, Ai, Ai, Ai, Ai, Ai, Ai, Ai, Ai, Ai, Ai, Ai
Ha, Aa, Aa, Aa, Aa, Ai, Ai, Ai, Wwf, Ai, Ai^Bw/r, Wog^Bw/r, Ai, Wog, Ai, 1 Ai, Ai, Ai, Ss, Aa, Ai, Ai, Ai, Aa^Fpa, Aa, Aa, Ai, Ai, Ai, Ai, Ai, Ai, Ai, Ai, Ai, Ai, Ai, Ai, Ai, Ai, Ai, Ai, Ai, Ai, Ai, Ai
Aa^Fpa, Aa, Aa, Aa, Aa, Aa, Aa, Ai, Rb, Ai^Bw/r, Ai, Ai, Ai, Ai, Ai, Ai, Ai, Ai, Ai, Ai, Ai, Ai, Ai, Aa, Ai, Ai, Ai, Ai, Ai, Ai, Ai, Ai, Ai, Ai, Ai, Ai, Ai, Ai, Ai, Ai, Ai, Ai, Ai, Ai, Aa, Aa
Aa^Fpa, Aa^Vca, Aa, Aa, Rb, Aa, Rb, Rb, Aa, Aa, Aa, Aa, Aa, Ai, Aa, Ai, Aa, Ai, Ai, Ai, Ai, Ai, Ai, Ai, Ai, Ai, Ai, Ai, Ai, Ai, Ai, Ai, Ai, Ai, Ai, Ai, Ai, Ai, Ai, Ai, Ai, Ai, Aa, Aa, Aa, Aa
Aa^Fpa, Aa^Fpa, Rb, Rb, Rb, Rb, Aa, Aa, Aa, Aa^Vca, Aa^Fpa, Aa, Aa^Fpa, Aa, Aa, Aa, Aa, Aa, Aa, Ai, Ai, Ai, Ai, Ai, Ai, Ai, Ai, Ai, Ai, Ai, Ai, Ai, Ai, Ai, Ai, Ai, Ai, Ai, Ai, Ai, Aa, Aa, Aa, Aa, Ha, Ha
Aa^Fpa, Aa^Fpa, Rb, Rb, Aa, Aa, Aa, Aa, Aa, Aa^Fpa, Aa^Fpa, Aa^Fpa, Aa^Fpa, Aa^Fpa, Aa^Fpa, Aa, Aa, Aa, Aa, Aa, Aa, Aa, Aa, Ai, Ai, Ai, Ai, Ai, Ai, Ai, Ai, Ai, Ai, Ai, Aa, Aa, Aa, Aa, Aa, Aa, Aa, Aa, Ha, Ha, Ha, Ha
