Qxu, Qxu, Qxu, Qxu, Qxu, Qxu, Qxu, Qxu, Qxu, Qxu, Qxu, Qxu, Qxu, Qxu, Qxu, Qxu, Qxu, Qxu, Qxu, Qxu, Qxu, Qxu, Qxu, Qxu, Qxu, Qxu, Qxu, Qxu, Xu, Qxu, Xu, Qxu, Qxu, Xu, Xu, Xu, Xu, Xu, Xu, Xu, Xu, Xu, Xu, Xu, Xu, Xu, Xu, Xu, Xu, Xu, Xu, Ql, Ql, Ql, Xu, Xu, Xu, Xu, Xu, Xu, Qlf, Xu, Ql, Ql, Ql, Xu, Xu, Xu, Qlf, Xu, Qlf, Xu
Qxu, Qxu, Qxu, Qxu, Xu, Qxu, Qxu, Qxu, Qxu, Qxu, Qxu, Qxu, Qxu, Qxu, Qxu, Qxu, Qxu, Qxu, Qxu, Qxu, Qxu, Qxu, Qxu, Uu^Vu, Xu, Uh, Xu, Xu, Xu, Xu, Xu, Xu, Xu, Xu, Xu, Xu, Xu, Xu, Xu, Xu, Qlf, Qlf, Qlf, Ql, Uu, Uu, Uu, Xu, Xu, Xu, Xu, Ql, Ql, Ql, Ql, Xu, Ql, Ql, Ql, Qlf, Qlf, Ql, Ql, Ql, Ql, Ql, Ql, Qlf, Qlf, Qlf, Qlf, Qlf
Xu, Xu, Xu, Xu, Xu, Xu, Xu, Qxu, Qxu, Qxu, Qxu, Qxu, Qxu, Qxu, Qxu, Qxu, Qxu, Qxu, Qxu, Qxu, Qxu, Qxu, Xu, Xu, Xu, Xu, Xu, Xu, Xu, Xu, Xu, Xu, Xu, Xu, Xu, Xu, Xu, Xu, Qlf, Qlf, Qlf, Ql, Ql, Ql, Ql, Ql, Uu, Uu, Uu, Xu, Uu, Ql, Ql, Ql, Ql, Ql, Ql, Ql, Ql, Ql, Ql, Ql, Ql, Ql, Ql, Ql, Ql, Ql, Ql, Qlf, Qlf, Qlf
Xu, Xu, Xu, Xu, Xu, Xu, Xu, Xu, Xu, Xu, Xu, Xu, Xu, Qxu, Qxu, Qxu, Qxu, Qxu, Qxu, Qxu, Qxu, Qxu, Xu, Xu, Xu, Xu, Xu, Xu, Xu, Xu, Xu, Xu, Xu, Xu, Xu, Xu, Xu, Qlf, Qlf, Ql, Ql, Ql, Ql, Ql, Ql, Ql, Uu, Uu, Uu, Qxu, Qxu, Qxu, Qxu, Qxu, Qxu, Qxu, Qxu, Qxu, Qxu, Qxu, Qxu, Qxu, Qxu, Qxu, Qxu, Qxu, Ql, Ql, Ql, Qlf, Qlf, Qlf
Uu, Uu, Uu, Uu, Uu, Xu, Xu, Xu, Xu, Xu, Xu, Xu, Xu, Xu, Xu, Xu, Xu, Xu, Xu, Xu, Xu, Xu, Xu, Xu, Xu, Xu, Xu, Xu, Xu, Xu, Xu, Xu, Xu, Xu, Xu, Xu, Xu, Ql, Ql, Ql, Ql, Qxu, Ql, Ql, Ql, Qxu, Uu, Qxu, Qxu, Qxu, Qxu, Qxu, Qxu, Qxu, Qxu, Qxu, Qxu, Qxu, Qxu, Qxu, Qxu, Qxu, Qxu, Qxu, Qxu, Qxu, Qxu, Qxu, Ql, Ql, Ql, Qlf
Uu, Uu, Ur, Uu, Ur, Uu, Uu, Xu, Uu, Xu, Xu, Xu, Xu, Xu, Xu, Xu, Xu, Xu, Xu, Xu, Xu, Xu, Xu, Xu, Xu, Xu, Xu, Xu, Xu, Xu, Xu, Xu, Xu, Xu, Xu, Xu, Xu, Ql, Ql, Ql, Qxu, Qxu, Qxu, Qxu, Qxu, Qxu, Qxu, Qxu, Qxu, Qxu, Qxu, Qxu, Qxu, Qxu, Qxu, Qxu, Qxu, Qxu, Qxu, Qxu, Qxu, Qxu, Qxu, Qxu, Qxu, Qxu, Qxu, Qxu, Qxu, Qxu, Ql, Ql
Ur, 5 Ur, Uu, Ur, Uu, Ur, Ur, Uu, Uu, Uu, Uu, Xu, Xu, Xu, Xu, Xu, Xu, Xu, Xu, Xu, Xu, Xu, Xu, Xu, Xu, Xu, Xu, Xu, Xu, Xu, Xu, Xu, Xu, Xu, Xu, Xu, Xu, Ql, Ql, Qxu, Qxu, Qxu, Qxu, Qxu, Qxu, Qxu, Qxu, Qxu, Qxu, Qxu, Uu, Qxu, Uu, Qxu, Uu, Qxu, Uu, Uu, Uu, Qxu, Uu, Uu, Uu, Uu, Uu, Qxu, Qxu, Qxu, Qxu, Qxu, Ql, Ql
Uu, Uu, Xu, Uu, Uh, Uu, Uu, Ur, Ur, Uu, Uu, Uu, Xu, Xu, Xu, Xu, Xu, Xu, Xu, Xu, Xu, Xu, Xu, Xu, Xu, Xu, Xu, Xu, Xu, Xu, Xu, Xu, Xu, Xu, Xu, Xu, Xu, Ql, Qxu, Qxu, Qxu, Qxu, Qxu, Qxu, Uu, Qxu, Uu, Uu, Uu, Uu, Uu, Uu, Urb, Uu, Urb, Uu, Urb, Uu, Urb, Uu, Urb, Uu, Urb, Uu, Uu, Uu, Uu, Qxu, Qxu, Qxu, Qxu, Ql
Xu, Xu, Xu, Xu, Xu, Uh, Uh, Uu, Ur, Uu, Uh, Xu, Xu, Xu, Xu, Xu, Uu, Uu, Uu, Xu, Uu, Uu, Uu, Uu, Uu, Uu, Uu, Xu, Xu, Xu, Xu, Xu, Xu, Xu, Xu, Xu, Xu, Ql, Qxu, Qxu, Qxu, Qxu, Uu, Uu, Uu, Uu, Uu, Uu, Urb, Urb, Urb, Urb, Uu, Urb, Xu, Urb, Xu, Urb, Xu, Urb, Xu, Urb, Urb, Urb, Uu, Uu, Uu, Uu, Qxu, Qxu, Qxu, Ql
Xu, Xu, Xu, Xu, Xu, Xu, Uu, Uu, Ur, Uu, Uu, Xu, Xu, Xu, Xu, Uu, Xu, Uu, Uu, Uu, Xu, Xu, Xu, Xu, Xu, Uu, Uu, Xu, Xu, Xu, Xu, Xu, Xu, Xu, Xu, Xu, Xu, Ql, Qxu, Qxu, Qxu, Uu, Uu, Uu, Urb, Urb, Urb, Urb, Xu, Uu, Xu, Uu, Xu, Xu, Xu, Xu, Xu, Xu, Xu, Xu, Xu, Xu, Uh, Urb, Urb, Uu, Uu, Xu, Qxu, Qxu, Qxu, Ql
Xu, Xu, Xu, Xu, Xu, Xu, Uu, Ur, Ur, Ur, Ur, Uu, Uu, Xu, Xu, Xu, Xu, Xu, Xu, Xu, Xu, Xu, Xu, Xu, Xu, Xu, Xu, Uu, Uu, Xu, Xu, Xu, Xu, Xu, Xu, Xu, Xu, Xu, Qxu, Qxu, Qxu, Uu, Uu, Urb, Urb, Xu, Xu, Xu, Xu, Xu, Xu, Xu, Xu, Xu, Xoa, Xu, Xu, Xu, Xoa, Xu, Xu, Xu, Xu, Uh, Uu, Urb, Uu, Xu, Xu, Qxu, Qxu, Ql
Xu, Xu, Xu, Xu, Xu, Xu, Xu, Uu, Uu, Ur, Ur, Uu, Uu, Xu, Xu, Xu, Xu, Xu, Xu, Xu, Xu, Xu, Xu, Xu, Xu, Xu, Xu, Xu, Uu, Xu, Xu, Xu, Xu, Xu, Xu, Xu, Xu, Xu, Qxu, Qxu, Qxu, Uu, Uu, Urb, Xu, Xu, Xu, Xu, Xoa, Xu, Xu, Xu, Xu, Xu, Qxu^Pyg, Qxu^Pyg, Qxu^Pyg, Qxu^Pyg, Qxu^Pyg, Xu, Xu, Xu, Xu, Xu, Uu, Urb, Xoa, Xu, Xu, Qxu, Qxu, Ql
Xu, Xu, Xu, Xu, Xu, Xu, Xu, Xu, Uh, Uu, Uu, Ur, Uu, Uu, Xu, Xu, Xu, Xu, Xu, Xu, Xu, Xu, Xu, Xu, Xu, Xu, Xu, Xu, Xu, Uu, Uu, Uu, Uu, Xu, Xu, Xu, Xu, Xu, Qxu, Qxu, Qxu, Uu, Ur, Urb, Xu, Xu, Xoa, Xoa, Uu^Vud, Xoa, Uu^Vud, Xu, Xu, Xu, Cpy, Qxu^Pyg, 2 Kpy, Qxu^Pyg, Cpy, Xu, Xu, Xu, Xoa, Xoa, Urb, Urb, Uu, Xoa, Xu, Qxu, Qxu, Ql
Xu, Xu, Xu, Xu, Xu, Xu, Xu, Xu, Uu, Uh, Ur, Ur, Uu, Uu, Xu, Xu, Xu, Xu, Xu, Xu, Xu, Xu, Xu, Xu, Xu, Xu, Xu, Xu, Xu, Xu, Xu, Xu, Xu, Uu, Uu, Uu, Uu, Uu, Xu, Qxu, Qxu, Uu, Ur, Xu, Xu, Xu, Uu^Vud, Ias, Uu, Ias, Ias, Xoa, Xu, Xu, Xoa, Cpy, Cpy, Cpy, Xu, Xu, Xu, Xu, Uh, Uu, Urb, Urb, Uu, Uh, Qxu, Qxu, Qxu, Ql
Xu, Xu, Xu, Xu, Xu, Xu, Xu, Xu, Uu, Uu, Ur, Uu, Uu, Uu, Xu, Xu, Xu, Xu, Xu, Xu, Xu, Xu, Xu, Xu, Xu, Xu, Xu, Xu, Xu, Xu, Xu, Xu, Xu, Xu, Uu, Uu, Xu, Xu, Xu, Qxu, Qxu, Uu, Ias, Xoa, Xu, Xu, Ias, Ias, Ur, Uu, Uu, Ias, Xoa, Xu, Uh, Uh^Pyg, Urb^Pyg, Uh^Pyg, Xu, Xu, Xu, Xu, Uh, Uu, Urb, Uu, Uu, Uu, Qxu, Qxu, Qxu, Ql
Xu, Xu, Xu, Xu, Xu, Xu, Xu, Xu, Uu, Uu, Ur, Uu, Uu, Xu, Xu, Xu, Xu, Xu, Xu, Xu, Xu, Xu, Xu, Xu, Xu, Xu, Xu, Xu, Xu, Xu, Xu, Xu, Xu, Xu, Uu, Xu, Xu, Xu, Xu, Qxu, Qxu, Uu, Ias, Xoa, Xu, Xu, Uu, Ias, Ur, Ur, Uu^Vud, Uu, Ias, Uh, Urb, Urb, Uu, Uh, Xu, Xu, Uh, Uh, Uu, Urb, Uu, Uu, Uu, Uu, Qxu, Qxu, Qxu, Ql
Xu, Xu, Xu, Xu, Xu, Xu, Xu, Xu, Xu, Uu, Ur^Es, Uu^Es, Uu^Es, Uu, Xu, Xu, Xu, Xu, Xu, Xu, Xu, Xu, Xu, Xu, Xu, Xu, Xu, Xu, Xu, Xu, Xu, Xu, Uu, Uu, Xu, Xu, Xu, Xu, Xu, Qxu, Qxu, Uu, Ias, Xoa, Xu, Xu, Uu, Uu, Ur, Ias, Ias, Uu, Ur, Ur, Urb, Urb, Uh, Uu, Xu, Xu, Xu, Uu, Urb, Urb, Uu, Uu, Uh, Uu, Qxu, Qxu, Qxu, Ql
Xu, Xu, Uh, Uh, Ur, Xu, Xu, Xu, Xu, Uu, Uu, Ur^Es, Ur, Uu, Xuc, Xu, Xu, Xu, Xu, Xu, Xu, Xu, Xu, Xu, Xu, Xu, Xu, Xu, Xu, Xu, Xu, Xu, Uu, Uu, Xu, Xu, Xu, Xu, Xu, Qxu, Qxu, Uu, Ias, Xoa, Xu, Xu, Uu, Ias, Ias, Ur, Ur, Ur, Uh, Urb, Uh, Uh, Xu, Xu, Xu, Xu, Uu^Vud, Uu, Urb, Uu, Uh, Uh, Uu, Qxu, Qxu, Qxu, Qxu, Ql
Xu, Uh, Uh, Uu, Qxu, Uu, Uu, Xu, Xu, Uh, Uu, Uu, Ur, Uu, Xu, Xu, Xu, Xuc, Xu, Xuc, Uu, Uu, Uu, Uu, Uu, Xu, Uu, Xu, Qxu, Xu, Xu, Xu, Uu, Xu, Xu, Xu, Xu, Xu, Qxu, Qxu, Qxu, Uu, Ias, Xoa, Xu, Xu, Uh, Ias, Ur, Uh, Uh, Uh, Xu, Uh, Xu, Xu, Xu, Xu, Qxu, Xu, Uh, Uh, Urb, Uu, Uh, Uh, Uu, Qxu, Qxu, Qxu, Ql, Ql
Xu, Uh, Uh, Ur, Qxu, Qxu, Uu, Xu, Xu, Xu, Uh, Uu, Ur, Uu, Xu, Xu, Xu, Xu, Xu, Uu, Qxu, Uu, Qxu, Uu, Qxu, Uu, Qxu, Uu, Uu, Uu, Uu, Uu, Xu, Xu, Qxu, Qxu, Xu, Xu, Qxu, Qxu, Qxu, Ias, Ias, Xoa, Xoa, Xu, Uh, Uu, Ur, Uh, Xoa, Xu, Xu, Xu, Xu, Xu, Xu, Qxu, Qxu, Uh, Uu, Urb, Urb, Uu, Uu, Uu, Qxu, Qxu, Qxu, Ql, Ql, Qlf
Xu, Xu, Xu, Uh, Uu, Ur, Ur^Es, Uu, Uh, Xu, Uh, Uu, Ur, Uu, Xu, Xu, Xu, Xu, Xu, Xu, Xu, Qxu, Xu, Qxu, Xu, Qxu, Qxu, Qxu, Qxu, Uu, Uu, Uu, Xu, Qxu, Uh, Xu, Xu, Qxu, Qxu, Qxu, Qxu, Urb, Uu, Ias, Xu, Xu, Xu, Uh, Ur, Ias, Ias, Xoa, Xu, Xu, Uh, Xu, Qxu, Qxu, Uu, Uu, Uu, Uu, Urb, Uu, Uu, Qxu, Qxu, Qxu, Ql, Ql, Ql, Qlf
Xu, Xu, Xu, Xu, Xu, Uu, Ur^Es, Uu, Uu, Xu, Uu, Ur, Uh, Uh, Xuc, Xu, Xu, Xu, Xu, Xu, Xu, Xu, Xu, Xu, Xu, Xu, Xu, Xu, Qxu, Qxu, Qxu, Uu, Uu, Ww, Uh, Uh, Uh, Xu, Qxu, Qxu, Qxu, Ias, Uu, Uu, Xoa, Xu, Uh, Uh, Ur, Uu, Uu, Ias, Xu, Xu, Xu, Uh, Qxu, Uu, Qxu, Uu, Uu, Urb, Urb, Uu, Uu, Qxu, Qxu, Qxu, Ql, Ql, Ql, Qlf
Xu, Xu, Xu, Xu, Xu, Uh, Uh, Ur, Ur, Uu, Uu, Ur, Ur, Uh, Xu, Xu, Xu, Xu, Xu, Xu, Xu, Xu, Xu, Xu, Xu, Xu, Xu, Xu, Xu, Qxu, Qxu, Uu, Xu, Wwf, Wwf, Ww, Ww, Uh, Qxu, Qxu, Qxu, Urb, Ias, Ias, Ias, Xoa, Uh, Uh, Cay, Uu, Uu, Uu, Xu, Xu, Xu, Qxu, Qxu, Qxu, Qxu, Qxu, Uu, Uu, Urb, Uu, Uu, Qxu, Qxu, Qxu, Ql, Qlf, Qlf, Xu
Xu, Xu, Xu, Xu, Xu, Xu, Xu, Uh, Uh, Ur, Ur, Ur, Ur, Uu, Xu, Xu, Xu, Xu, Xu, Xu, Xu, Xu, Xu, Xu, Xu, Xu, Xu, Xu, Xu, Xu, Xu, Qxu, Xu, Wwf, Wwf, Wwf, Wwf, Wwf, Qxu, Qxu, Qxu, Uu, Ias, Ur, Uu, Uh, Cay, Kay, Cay, Qxu, Qxu, Uu, Uu, Xu, Xu, Qxu, Qxu, Qxu, Qxu, Qxu, Uu, Uu, Urb, Uu, Uu, Qxu, Qxu, Qxu, Ql, Ql, Ql, Ql
Xu, Xu, Xu, Xu, Xu, Xu, Xu, Uu, Uu, Uu, Uu, Ur, Uu, Uu, Ur, Xu, Xu, Xu, Xu, Xu, Xu, Xu, Xu, Xu, Xu, Xu, Xu, Xu, Xu, Xu, Xu, Xu, Xu, Uh, Uh, Ww, Ww, Wwf, Qxu, Qxu, Qxu, Uu, Uu, Ias, Ur, Ur, Ur, Cay, Qxu, Qxu, Qxu, Uu, Uu, Xu, Xu, Xu, Xu, Qxu, Xu, Xu, Xu, Cay, Urb, Uu, Xu, Qxu, Qxu, Qxu, Ql, Ql, Ql, Ql
Xu, Xu, Xu, Xu, Xu, Xu, Xu, Xu, Xu, Uh, Uu, Ur, Uu, Xu, Uu, Xu, Xu, Xu, Xu, Xu, Xu, Xu, Xu, Xu, Xu, Xu, Xu, Xu, Xu, Xu, Xu, Xu, Xu, Qlf, Qlf, Uh, Uh, Uh, Qxu, Qxu, Qxu, Uu, Uu, Uu, Ur, Ur, Ias, Xoa, Xoa, Xu, Xu, Uu, Uu, Xu, Xu, Xu, Xu, Qxu, Qxu, Uu^Vu, Uu, Urb, Uu, Xu, Xu, Qxu, Qxu, Qxu, Ql, Ql, Ql, Xu
Xu, Xu, Xu, Xu, Xu, Xu, Xu, Xu, Xu, Uh, Uh, Ur, Uu, Xu, Xu, Uu, Xu, Xu, Xu, Xu, Xu, Xu, Xu, Xu, Xu, Xu, Xu, Xu, Xu, Xu, Xu, Xu, Xu, Qlf, Qlf, Qlf, Ql, Ql, Qxu, Qxu, Qxu, Uu, Uu, Uu, Uu, Ias, Ur, Ias, Ias, Xoa, Uu, Uu, Uu, Uh, Uh, Xu, Xu, Xu, Qxu, Uu, Uu, Urb, Uu, Uu, Uu, Qxu, Qxu, Qxu, Ql, Xu, Xu, Xu
Xu, Xu, Xu, Xu, Uh, Xu, Xu, Xu, Xu, Uh, Uu, Ur, Uh, Xu, Xu, Uu, Uu, Xu, Xu, Xu, Xu, Xu, Xu, Xu, Xu, Xu, Xu, Xu, Xu, Xu, Xu, Xu, Xu, Qlf, Qlf, Qlf, Ql, Ql, Qxu, Qxu, Qxu, Qxu, Qxu, Uu, Uu, Uu, Uu, Ur, Ur, Uu, Ur, Uu, Uu, Uu, Uh, Uh, Xu, Xu, Qxu, Urb, Urb, Urb, Urb, Uu, Uu, Qxu, Qxu, Ql, Ql, Xu, Xu, Xu
Xu, Xu, Xu, Xu, Uu, Uh, Uh, Xu, Uu, Uu, Ur, Ur, Uu, Xu, Ur, Uu, Uu, Xu, Xu, Xu, Xu, Xu, Xu, Xu, Xu, Xu, Xu, Xu, Xu, Xu, Xu, Xu, Xu, Qlf, Qlf, Qlf, Ql, Ql, Ql, Ql, Qxu, Qxu, Qxu, Qxu, Qxu, Uu, Uu, Uu, Cay, 1 Cay, Cay, Ur, Ur, Uu, Uh, Uh, Xu, Xu, Xu, Urb, Urb, Urb, Urb, Uu, Qxu, Qxu, Qxu, Ql, Ql, Xu, Xu, Xu
Xu, Xu, Xu, Xu, Xu, Uu, Uu, Uu^Dr, Uu, Ur, Uu, Ur, Ur, Uu, Uu, Uu, Xu, Xu, Xu, Xu, Xu, Xu, Xu, Xu, Xu, Xu, Xu, Xu, Xu, Xu, Xu, Xu, Xu, Qlf, Qlf, Qlf, Ql, Ql, Ql, Ql, Ql, Qxu, Qxu, Qxu, Qxu, Qxu, Qxu, Uu, Uu, Kay, Cay, Uu, Rr, Uu, Xu, Xu, Xu, Xu, Uu, Urb, Urb, Urb, Uu, Uu, Qxu, Qxu, Qxu, Ql, Xu, Xu, Xu, Xu
Xu, Xu, Xu, Xu, Xu, Xu, Uu, Ur, Ur, Ur, Uu, Uu, Xu, Uu, Xu, Xu, Xu, Xu, Xu, Xu, Xu, Xu, Xu, Xu, Xu, Xu, Xu, Xu, Xu, Xu, Xu, Xu, Xu, Qlf, Qlf, Qlf, Ql, Ql, Ql, Ql, Ql, Ql, Ql, Qxu, Qxu, Qxu, Qxu, Qxu, Qxu, Uu, Uu, Uu, Rr, Uu, Xu, Xu, Xu, Uu, Uu, Urb, Urb, Urb, Uu, Uu, Qxu, Qxu, Qxu, Xu, Xu, Xu, Xu, Xu
Xu, Xu, Xu, Xu, Xu, Xu, Uu, Ur, Uu, Uu, Uh, Uh, Xu, Xu, Xu, Xu, Xu, Xu, Xu, Xu, Xu, Xu, Xu, Xu, Xu, Xu, Xu, Xu, Xu, Xu, Xu, Xu, Xu, Qlf, Qlf, Qlf, Qlf, Qlf, Qlf, Qlf, Ql, Ql, Ql, Ql, Ql, Qxu, Qxu, Qxu, Qxu, Qxu, Uu, Uu^Vud, Rr, Uu^Vud, Uu^Vud, Xu, Xu, Cay, Cay, Urb, Urb, Urb, Cay, Cay, Qxu, Qxu, Qxu, Xu, Xu, Xu, Xu, Xu
Xu, Xu, Xu, Xu, Uh, Uh, Ur, Ur, Uu^Dr, Uh, Uh, Xu, Xu, Xu, Xu, Xu, Xu, Xu, Xu, Xu, Xu, Xu, Xu, Xu, Xu, Xu, Xu, Xu, Xu, Xu, Xu, Xu, Xu, Qlf, Qlf, Qlf, Qlf, Qlf, Qlf, Qlf, Qlf, Ql, Qlf, Ql, Ql, Ql, Ql, Qxu, Qxu, Qxu, Uu, Uu^Vud, Rr, Uu^Vud, Xu, Xu, Xu, Xu, Cay, Uu, Ur, Uu, Cay, Cay, Cay, Qxu, Xu, Xu, Xu, Xu, Xu, Xu
Xu, Xu, Xu, Xu, Xu, Uu, Uu, Ur^Es, Ur^Es, Uu, Uu, Xu, Xu, Xu, Xu, Xu, Xu, Xu, Xu, Xu, Xu, Xu, Xu, Xu, Xu, Xu, Xu, Xu, Xu, Xu, Xu, Xu, Xu, Qlf, Qlf, Qlf, Qlf, Qlf, Qlf, Qlf, Qlf, Qlf, Qlf, Qlf, Qlf, Ql, Xu, Xu, Xu, Xu, Xu, Uu^Vud, Uh, Uh, Xu, Xu, Xoa, Xu, Uu, Uu, Ias, Uu, Xu, Xu, Xu, Xu, Xu, Xu, Xu, Xu, Xu, Xu
Xu, Xu, Xu, Xu, Xu, Xu, Xu, Ur, Ur, Uu, Uu, Xu, Xu, Xu, Xu, Xu, Xu, Xu, Xu, Xu, Xu, Xu, Xu, Xu, Xu, Xu, Xu, Xu, Xu, Xu, Xu, Xu, Xu, Xu, Xu, Xu, Xu, Xu, Xu, Xu, Xu, Xu, Xu, Xu, Xu, Xu, Xu, Xu, Xu, Xu, Xu, Xu, Uh, Uh, Uh, Xu, Uu, Uu, Ias, Ias, Uu, Xu, Xu, Xu, Xu, Xu, Xu, Xu, Xu, Xu, Xu, Xu
Xu, Xu, Xu, Xu, Xu, Xu, Xu, Uu, Ur, Ur^Es, Ias, Uu, Uu, Xoa, Xu, Xu, Xoa^Efs, Xoa, Xoa, Xu, Uu, Xu, Xu, Xu, Xoa, Xu, Xoa^Efs, Cud, Xoa, Xu, Xu, Xu, Xu, Xu, Xu, Xu, Xu, Xu, Xu, Xu, Xu, Xu, Xu, Xu, Xu, Xu, Xu, Xu, Xu, Xu, Xu, Xu, Xu, Uh, Uh, Uu^Vud, Uu, Uu, Ur, Ias, Uu, Xu, Xu, Xu, Xu, Xu, Uu, Uu, Ur, Cay, Ias, Xu
Xu, Xu, Xu, Xu, Xu, Xu, Uh, Uu, Uu, Ias, Ias, Uu, Uu^Es, Uu, Uu, Uu, Ias, Ias, Uu, Uu, Uu, Uu, Uu, Uu, Uu, Ias, Ias, Ias, Ias, Ur, Xu, Xu, Xu, Xu, Xu, Xu, Uu, Uh, Xu, Xoa, Uu^Vud, Xu, Cay, Xu, Uu, Xu, Uh, Uh, Uh, Xu, Xu, Xu, Uh, Uh, Uu, Uu, Ias, Ur, Uu, Uu, Xu, Xu, Xu, Xu, Uu, Uu, Ias, Ias, Uu^Vud, Ias, Ur, Ias
Xu, Xu, Xu, Xu, Xu, Xu, Xu, Uu, Uu, Ias, Cay, Ias, Ias, Ias^Es, Ur, Ur, Ur, Ias, Ias, Ias, Ias, Ur, Ur, Ur, Ias, Uu, Uu^Vud, Uu, Ur, Ur, Xu, Xu, Xu, Xu, Xu, Uh, Uh, Ias, Uu, Uu, Uu, Uu, Uu, Uu, Uu, Uu, Uu, Uh, Uh, Uh, Xu, Xu, Xu, Uu, Ias, Ias, Uu, Uu, Uu, Xu, Xu, Xu, Xu, Uh, Ias, Ur, Uu, Uu, Uu, Uu, Wwf, Ur
Xu, Xu, Xu, Xu, Xu, Xu, Xu, Uu, Uh, Cay, Kay, Cay, Uu, Uu, Uu, Uu^Dr, Uu, Uu, Uu, Ias, Uu, Uu, Uu, Uu, Uu, Cay, Uu, Uu^Es, Uu^Es, Ur^Es, Xuc, Xuc, Xuc, Xu, Uh, Uu, Uu, Ias, Ias, Ias, Ias, Ias, Ias, Uu, Ias, Uu, Ias^Edt, Uu, Uu, Uh, Uh, Xu, Cay, Uu, Ur, Uu, Uu, Uu, Xu, Xu, Xu, Uh, Ur, Ias, Uu, Uu, Xu, Cay, Uu, Uu, Wwf, Ur
Xu, Xu, Xu, Xu, Xu, Xu, Xu, Uh, Uh, Cay, Cay, Cay, Uu, Uu, Uu, Uu^Es, Uu, Uu, Uu, Uu, Uu, Uu, Uu, Uu, Xu, Xu, Uu, Uu^Dr, Uu, Ur, Xuc, Ur, Xuc, Xuc, Uu, Ias, Ias, Uu, Uu, Uu, Uu, Uu, Cay, Ias, Uu, Ias, Uu, Ias, Ur, Uu, Uu, Uu, Ur, Ias, Uu, Uu, Uu, Xu, Xu, Xu, Xu, Uh, Ur, Ur, Wwf, Xu, Xu, Xu, Uu, Wwf, Tb^Tf, Ur
Xu, Xu, Xu, Xu, Xu, Xu, Xu, Xu, Xu, Xu, Xu, Xu, Xu, Xu, Xu, Xu, Xu, Xu, Xu, Xu, Xu, Uu, Xu, Xu, Xu, Xu, Uu, Uu, Tb^Tf, Ur^Es, Ur^Es, Ur, Ur^Es, Ur, Xu, Ias, Uu, Uh, Uu, Xu, Xu, Uu, Xu, Uu, Uu, Uu, Uu, Uu, Uu, Ur, Ias, Ur, Uu, Cay, Uu, Uu, Uu, Xu, Xu, Uh, Uh, Wwg, Wwg, Wwg, Wwg, Xu, Xu, Xu, Uu, Wwf, Tb^Tf, Wwf
Xu, Xu, Xu, Xu, Xu, Xu, Xu, Xu, Xu, Xu, Xu, Xu, Xu, Xu, Xu, Xu, Xu, Xu, Xu, Xu, Xu, Xu, Xu, Xu, Xu, Xu, Xu, Xu, Tb^Tf, Uu, Ur^Dr, Xuc, Uu, Ur, Ias, Uu, Uh, Uh, Xu, Xu, Xu, Xu, Xu, Xu, Xu, Xu, Xuc, Uu, Uu, Uu, Urb, Ur, Uu, Uu, Uu, Uu, Xu, Xu, Xu, Uh, Wwf, Wwg, Wwg, Wog, Wog, Wog, Xu, Xu, Uh, Wwg, Wog, Wwf
Xu, Xu, Xu, Xu, Xu, Xu, Xu, Xu, Xu, Xu, Xu, Xu, Xu, Xu, Xu, Xu, Xu, Xu, Xu, Xu, Xu, Xu, Xu, Xu, Xu, Xu, Xu, Xu, Xu, Xuc, Xu, Xuc, Xu, Xu, Ias, Uu, Uh, Uh, Xu, Xu, Xu, Xu, Xu, Xu, Xu, Xu, Xuc, Uu, Uu, Uu^Dr, Urb, Uu, Uu, Cay, Xu, Xu, Xu, Xu, Uu, Wwf, Rb, Ur, Uu, Wwf, Xu, Wog, Wog, Xu, Wwrg, Wog, Wog, Wog
Xu, Xu, Xu, Xu, Xu, Xu, Xu, Xu, Xu, Xu, Xu, Xu, Xu, Xu, Xu, Xu, Xu, Xu, Xu, Xu, Xu, Xu, Xu, Xu, Xu, Xu, Xu, Xu, Xu, Xu, Xu, Xu, Xu, Xu, Ias, Uu, Uh, Xu, Xu, Xu, Xu, Xu, Xu, Xu, Xu, Xu, Xuc, Uu, Uu, Xuc, Xu, Xu, Xu, Xu, Xu, Xu, Xu, Uu, Ur, Rb, Rb, Uu, Uu, Uu^Vud, Xu, Xu, Xu, Wog, Wog, Wog, Wog, Wwg
Xu, Xu, Xu, Xu, Xu, Xu, Xu, Xu, Xu, Xu, Xu, Xu, Xu, Xu, Xu, Xu, Xu, Xu, Xu, Xu, Xu, Xu, Xu, Xu, Xu, Xu, Xu, Xu, Xu, Xu, Xu, Xu, Xu, Xu, Ur, Uu, Uu, Xu, Xu, Xu, Xu, Xu, Xu, Xu, Xu, Xuc, Uu^Dr, Uu, Uu^Dr, Xuc, Xu, Xu, Xu, Xu, Xu, Xu, Uu, Ur, Ur, Uu, Xu, Xu, Xu, Xu, Xu, Xu, Xu, Wwrg, Wog, Wwg, Wog, Wwg
Xu, Xu, Xu, Xu, Xu, Xu, Xu, Xu, Xu, Xu, Xu, Xu, Xu, Xu, Xu, Xu, Xu, Xu, Xu, Xu, Xu, Xu, Xu, Xu, Xu, Xu, Xu, Xu, Xu, Xu, Xu, Xu, Xu, Xu, Ias, Ias, Ias, Uu, Uu, Xu, Xu, Xu, Xu, Xu, Xu, Xu, Xu, Uu, Uu, Xu, Xu, Xu, Xu, Xu, Uu, Ur, Ur, Ur, Uu, Xu, Xu, Xu, Xu, Xu, Xu, Xu, Wwrg, Wwrg, Rb, Wwf, Wog, Wog
Xu, Xu, Xu, Xu, Xu, Xu, Xu, Xu, Xu, Xu, Xu, Xu, Xu, Xu, Xu, Xu, Xu, Xu, Xu, Xu, Xu, Xu, Xu, Xu, Xu, Xu, Xu, Xu, Xu, Xu, Xu, Xu, Xu, Xu, Uu, Ias, Uu, Uu, Uu, Uu, Uu, Uu, Uh, Uh, Uh, Uh, Uh, Uu, Uu, Ur, Cay, Ur, Uu, Ur, Urb, Ur, Uu, Uu, Co, Uu, Uh, Xu, Xu, Xu, Xu, Uh, Wwf, Wwf, Rb, Wog, Uu, Xu
Xu, Xu, Xu, Xu, Xu, Xu, Xu, Xu, Xu, Xu, Xu, Xu, Xu, Xu, Xu, Xu, Xu, Xu, Xu, Xu, Xu, Xu, Xu, Xu, Xu, Xu, Xu, Xu, Xu, Xu, Xu, Xu, Xu, Xu, Xu, Xu, Ur, Ur, Ur, Ur, Uu, Ur, Uu, Uu, Uu, Urb, Urb, Urb, Urb, Uu, Ur, Ur, Ur, Ur, Urb, Uu, Uu, Co, Ko, Co, Uh, Uu^Vu, Xu^Efs, Uh, Uh, Uu, Uu, Rb, Rb, Xu, Xu, Xu
Xu, Xu, Xu, Xu, Xu, Xu, Xu, Xu, Xu, Xu, Xu, Xu, Xu, Xu, Xu, Xu, Xu, Xu, Xu, Xu, Xu, Xu, Xu, Xu, Xu, Xu, Xu, Xu, Xu, Xu, Xu, Xu, Xu, Xu, Xu, Xu, Uu^Vud, Uu, Uu, Uu, Ur, Uu, Urb, Urb, Urb, Uu, Co, 3 Ko, Co, Uu, Cay, Uu, Uu, Uu, Xu, Xu, Uh, Co, 4 Co, Co, Uh, Uu, Uu, Uu, Uu, Rb, Rb, Tb^Tf, Tb^Tf, Xu, Xu, Xu
Xu, Xu, Xu, Xu, Xu, Xu, Xu, Xu, Xu, Xu, Xu, Xu, Xu, Xu, Xu, Xu, Xu, Xu, Xu, Xu, Xu, Xu, Xu, Xu, Xu, Xu, Xu, Xu, Xu, Xu, Xu, Xu, Xu, Xu, Xu, Xu, Xu, Xu, Xu, Uu, Uh, Uh, Uh, Uu^Vud, Uh, Uh, Uh, Co, Co, Uu, Uu, Uu, Uu, Tb^Tf, Xu, Xu, Xu, Uu, Uu, Rb, Rb, Ur, Ur, Ur, Ur, Tb^Tf, Uu, Xu, Xu, Xu, Xu, Xu
Xu, Xu, Xu, Xu, Xu, Xu, Xu, Xu, Xu, Xu, Xu, Xu, Xu, Xu, Xu, Xu, Xu, Xu, Xu, Xu, Xu, Xu, Xu, Xu, Xu, Xu, Xu, Xu, Xu, Xu, Xu, Xu, Xu, Xu, Xu, Xu, Xu, Xu, Xu, Xu, Xu, Xu, Xu, Xu, Xu, Xu, Xu, Xu, Xu, Xu, Xu, Uu, Xu, Xu, Xu, Xu, Xu, Xu, Uu, Rb, Rb, Ur, Ur, Uu, Uu, Uh, Xu, Xu, Xu, Xu, Xu, Xu
Xu, Xu, Xu, Xu, Xu, Xu, Xu, Xu, Xu, Xu, Xu, Xu, Xu, Xu, Xu, Xu, Xu, Xu, Xu, Xu, Xu, Xu, Xu, Xu, Xu, Xu, Xu, Xu, Xu, Xu, Xu, Xu, Xu, Xu, Xu, Xu, Xu, Xu, Xu, Xu, Xu, Xu, Xu, Xu, Xu, Xu, Xu, Xu, Xu, Xu, Xu, Xu, Xu, Xu, Xu, Xu, Xu, Xu, Uu, Ur, Cay, Cay, Cay, Uu, Uu, Uh, Xu, Xu, Xu, Xu, Xu, Xu
