Xof, Xof, Xof, Xof, Xof, Xof, Xof, Xof, Xof, Xof, Xof, Xof, Xof, Xof, Xof, Xof, Xos, Xos, Xof, Xof, Xof, Xof, Xof, Xof, Xof, Xof, Xof, Xof
Xof, Xof, Xof, Xof, Xof, Xof, Gll^Fp, Gll^Fp, Re, Gll^Fmw, Gs^Fp, Gs^Fmw, Gs^Fmw, Xof, Xof, Xof, Iwr, Ior, Ior, Xos, Gd^Fmw, Xof, Gll^Fp, Xof, Xof, Xof, Xof, Xof
Xof, Xof, Xof, Xof, Gd^Fp, Gd^Fmw, Gd, Re^Es, Re, Rp, Gs^Fp, Gs^Fp, Cvr, Gs^Efm, Gll^Efm, Xos^Efs, Xof, Iwr, Rp, Gd^Fmw, Gll^Fp, Gd^Fmw, Gll^Fp, Gll^Fp, Gd^Fmw, Xof, Xof, Xof
Gll^Fp, Xof, Xof, Xof, Gs^Ve, Gd^Fp, Gs^Fp, Gs^Fp, Gs^Fp, Gs^Fp, Gs^Fdw, Gll^Fp, 2 Kvr, Cvr, Cvr, Rp, Gd, Rr^Pr\, Xof, Rp, Gll^Fmw, Gll^Fmw, Ior, Ior, Ior, Gll^Fp, Re, Xof
Gll^Fp, Xof, Xof, Re, Re, Gll^Fmw, Re, Re, Rp, Cvr, Gd^Fdw, Cvr, Gd^Fdw, Gs^Fp, Cvr, Gd^Fp, Gd^Fetd, Gll^Fdy, Gs^Fp, Xof, Rr^Pr\, Gll^Fp, Ior, Iwr, Ior, Gll^Fp, Xof, Xof
Gll^Fp, Gll^Fp, Xof, Xof, Re, Rp, Gg^Efm, Rp, Rp, Cvr, Cvr, Gd^Fdw, Gd^Fdw, Cvr, Gs^Fmw, Gs^Fmw, Gll^Fp, Gs^Fp, Gs^Fp, Gs^Fp, Rp, Xof, Rr^Pr\, Gd^Fmw, Gll^Fp, Re, Xof, Xof
Gll^Fp, Gll^Fp, Xof, Re^Es, Gs, Gs^Efm, Gg^Efm, Rp, Rp, Re, Gd^Fmw, Gd^Fdy, Gd, Re, Re, Gd^Fmw, Gd, Rp, Re, Re, Gs^Fp, Gs^Fp, Rp, Xof, Xof, Xof, Xof, Xof
Rb^Fdy, Gll^Fp, Re, Xof, Gs^Fp, Gd, Gs^Fp, Gg, Re, Re, Rp, Gd^Fmw, Gll^Fmw, Re, Rp, Gs^Fmw, Gs^Fmw, Re, Gs^Fp, Re, Rp, Rp, Rp, Rp, Re, Xof, Xof, Gll^Fp
Rb^Fdy, Rb^Fdy, Xof, Xof, Re^Dr, Gs^Fp, Xof, Gll^Fp, Re, Re, Re^Es, Gll^Fmw, Re^Dr, Rp, Rp, Gs^Fmw, Gg^Efm, Gs^Efm, Gll^Fmw, Gs^Fmw, Re, Re^Es, Gd^Fdw, Gd^Ve, Gs^Fp, Re, Xof, Gll^Fp
Gll^Fp, Gll^Fp, Xof, Xof, Xof, Xof, Xof, Xof, Rp^Es, Re, Rp, Re, Gs^Fp, Re, Gd, Re, Re, Gg^Efm, Re, Rp, Re, Gll^Fp, Gs^Fp, Gd^Fp, Re^Em, Xof, Gll^Fp, Gll^Fp
Gll^Fp, Gll^Fp, Xof, Xof, Gll^Fp, Xof, Gll^Fp, Xof, Xof, Rp, Gs^Fmw, Rp, Rp, Re, Re^Edt, Re, Gs^Fp, Gs^Fmw, Gs^Fp, Gs^Fp, Gll^Fp, Gs^Fp, Gs^Fp, Gll^Fp, Xof, Xof, Gll^Fp, Gll^Fdy
Gll^Fp, Gll^Fp, Gll^Fp, Gll^Fp, Rp^Edt, Gd^Fetd, Gll^Fp, Gll^Fp, Gll^Fp, Gs^Eqf, Gs^Eqf, Gs^Fmw, Rp, Rp^Edt, Rp^Edt, Re, Gll^Fmw, Gs^Fp, Gs, Gd^Fetd, Re, Gs^Fp, Xof, Xof, Xof, Gll^Fp, Gll^Fp, Gll^Fp
Gll^Fp, Gll^Fp, Gll^Fp, Gs^Fp, Gs^Fp, Gll^Fp, Gll^Fp, Gll^Fp, Gs^Fp, Gs, Gll^Fmw, Gll^Eqf, Re, Re^Edt, Re, Gll^Eqf, Gll^Eqf, Gll^Eqf, Re^Es, Gd, Gs, Gs^Eqf, Gs^Dr, Gll^Fp, Gll^Fp, Gll^Fp, Gll^Fp, Gll^Fp
Gll^Fp, Gll^Fp, Gg^Fet, Gs^Fp, Gg^Es, Gg^Dr, Gs, Gs^Fp, Gs^Fp, Gs^Fp, Gs, Gs^Efm, Re, Re, Gs^Fp, Re, Gs, Gg, Gll^Fp, Re, Gs^Efm, Gs, Gs^Fp, Gs^Fp, Gll^Fp, Gll^Fp, Gll^Fp, Gll^Fp
Gll^Fp, Gll^Fp, Gll^Fp, Gll^Fmw, Gs, Gg^Es, Xof, Xof, Xof, Gg, Gg^Es, Re, Gll^Efm, Gs, Gs^Fp, Gs^Fp, Gs^Ve, Gll^Fp, Gll^Fp, Re, Re, Gs^Fp, Gll^Fmw, Gll^Fp, Gll^Fmw, Gg^Fet, Gll^Fp, Gll^Fp
Ss, Gll^Fp, Xof, Gs, Gs, Gs^Em, Gg, Gll^Fmw, Gll^Fp, Gs^Fp, Re, Re, Gg, Gll^Fp, Gs^Fp, Gs^Fp, Gll^Fmw, Gs^Fp, Gll^Fmw, Gll^Fp, Re, Re, Gg^Edt, Gd^Edt, Gd, Gd^Fp, Xof, Xof
Ss, Re, Re, Xof, Xof, Gg, Gll^Fmw, Gll^Fmw, Gg, Gs^Es, Re^Es, Gll^Fmw, Re^Edt, Gs^Edt, Re^Edt, Gll^Fp, Gs^Fp, Gs^Fp, Gs^Fp, Gll^Fp, Gll^Fp, Re^Edt, Re^Edt, Gg^Edt, Gll^Fp, Gd^Fp, Gd^Fdy, Xof
Re, Re, Xof, Xof, Gs^Fp, Xof, Xof, Gll^Fp, Gll^Fp, Gll^Fp, Re, Gs^Fdw, Gs, Re^Edt, Gll^Fp, Gll^Fp, Gd, Gll^Fp, Gll^Fp, Gd, Gll^Fp, Gd, Re, Re, Re, Gll^Fp, Rb^Fdy, Gll^Fdy
Xof, Xof, Gll^Fmw, Gs^Fp, Gs^Fp, Gs^Fmw, Gll^Fp, Gs^Fp, Gs^Fp, Gll^Fp, Gll^Fp, Gs, Gg, Gll^Fp, Gll^Fp, Gll^Fp, Gll^Fp, Gd, Xof, Xof, Xof, Gd, Gll^Fp, Gll^Fp, Re, Gd, Gll^Fp, Gll^Fp
Gll^Fp, Rb^Fdy, Gll^Fp, Gs^Fp, Gll^Fp, Gll^Fp, Re, Gs^Ve, Gll^Fp, Gll^Fp, Gll^Fdy, Gll^Fp, Re, Gll^Fp, Gll^Fp, Gll^Fp, Gd^Eqf, Xof, Gg, Gll^Fp, Gll^Efm, Xof, Gll^Eqf, Gll^Fp, Gll^Fp, Re, Gll^Fp, Rb^Fdy
Gll^Fp, Gll^Fp, Rb^Fdy, Gll^Fp, Gll^Fp, Gll^Fp, Re^Edt, Re, Re, Gll^Fp, Gll^Fp, Gll^Fp, Re, Gll^Fdw, Gd^Fmw, Gd^Eqf, Gd^Eqf, Gg^Efm, Ww, Rp, Ww^Ewl, Gg^Efm, Gll^Eqf, Gll^Eqf, Gll^Fp, Re, Gll^Fp, Gll^Fp
Gll^Fp, Gll^Fp, Gll^Fmw, Gll^Fmw, Gd^Eff, Gd, Gd^Edt, Gg^Edt, Gll^Fp, Re, Re, Re, Gll^Fp, Rb^Fdy, Gll^Fdw, Gd, Gd, Re, Re^Em, Wwf, Gll^Fp, Gll^Fp, Gll^Fp, Gll^Fp, Re, Re, Xof, Xof
Gll^Fp, Gd^Fp, Gd, Gd^Eff, Rb, Rb, Gd, Rb, Gg^Fet, Gll^Fp, Gll^Fp, Re, Re, Gll^Fp, Gll^Fp, Gll^Fmw, Gg^Edt, Gg^Edt, Gd^Edt, Gll^Fdw, Gll^Fp, Gll^Fdy, Gd^Edt, Re^Edt, Gll^Fmw, Gll^Fp, Xof, Xof
Gll^Fp, Gd^Fp, Xom, Sm, Sm, Rb, Gd^Eff, Gd^Eff, Gll^Fmw, Gll^Fp, Gll^Fp, Re, Gll^Fdw, Re, Re, Re, Gll^Fp, Gg^Edt, Re, Re, Gll^Fp, Re, Re, Gs^Fdw, Gll^Fmw, Rb^Fdy, Gll^Fp, Xof
Gll^Fp, Gll^Fp, Rb^Fdy, Xom, Xom, Xom, Gd^Fp, Gd^Fdy, Gd, Gll^Fdy, Gll^Fmw, Gg^Es, Re, Re, Re^Es, Gll^Fp, Gll^Fmw, Gll^Fp, Re, Gll^Fp, Gll^Fp, Gll^Fp, Gll^Fmw, Gd, Gs^Ve, Gll^Fp, Gll^Fp, Gll^Fp
Gll^Fp, Gll^Fp, Gll^Fp, Gll^Feth, Gd^Fmw, Gd^Fmw, Gd^Fdy, Gd, Gll^Fp, Gll^Fp, Gll^Fp, Gg, Re, 1 Re, Re, Gg^Em, Gll^Fp, Gll^Fp, Gll^Fp, Gll^Fp, Gll^Fp, Gll^Fp, Gll^Fp, Gll^Fp, Gll^Fp, Gll^Fp, Gll^Fp, Gll^Fp
Gll^Fp, Gll^Fp, Rb^Fdy, Gd^Fmw, Gd^Fmw, Gd^Fmw, Gll^Fmw, Gll^Fdy, Gll^Fp, Gll^Fp, Gll^Fp, Gll^Fp, Re, Re, Re, Gg, Gll^Fp, Gll^Fp, Gll^Fp, Gll^Fp, Gll^Fp, Gll^Fp, Gll^Fp, Gll^Fp, Gll^Fp, Gll^Fp, Gll^Fp, Gll^Fp
Gll^Fp, Gll^Fp, Gll^Fp, Gll^Fp, Gll^Fp, Gll^Fp, Gll^Fp, Gll^Fp, Gll^Fp, Gll^Fp, Gll^Fp, Gll^Fp, Re, Re, Re, Gll^Fp, Gll^Fp, Gll^Fp, Gll^Fp, Gll^Fp, Gll^Fp, Gll^Fp, Gll^Fp, Gll^Fp, Gll^Fp, Gll^Fp, Gll^Fp, Gll^Fp
