Xos, Xos, Xos, Xos, Xos, Xos, Xom, Xos, Xom, Xom, Xom, Xos, Xos, Xos
Xos, Xos, Urfz, Urfz, Urfz, Urfz, Urfz, Xom, Ce, Ce, Xom, Xos, Xos, Xos
Xos, Xos, Urfz, Urfz, Ce, Ce, Ce, Ce, Xom, Xom, Xos, Xos, Xos, Xos
Xos, Urfz, Urfz, Urfz, Xos, Xos, Xos, Xom, Xos, Xos, Urfz^Edb, Xos, Xos, Xos
Xos, Urfz, Urfz, Xos, Ds, Ds, Ds, Xos, Urfz^Edb, Urfz^Edb, Urfz^Edb, Urfz^Edb, Xos, Xos
Xos, Urfz, Urfz, Xos, Ds, Ds, Ds, Xos, Urfz^Edb, Urfz^Edb, Urfz^Edb, Xos, Xos, Xos
Xos, Urfz, Urfz, Xos, Xos, Ds, Rrc, Rrc^Bryl, Rrc, Urfz^Edb, Urfz^Edb, Urfz^Edb, Xos, Xos
Xos, Urfz, Urfz, Urfz, Urfz, Rrc^Bryl, Rrc, Rrc, Rrc, Rrc, Rrc, Urfz, Xos, Xos
Xos, Xos, Xos, Urfz, Urfz, Rrc, Rrc, Rrc, Rrc, Rrc, Rrc, Urfz, Xos, Xos
Xos, Xos, Xu, Xu, Xu, Urfz, Chr, Rrc, Urfz, Rrc, Xu, Xu, Xu, Xos
Xu, Xu, Cuay, Xu, Urfz, Chr, Urfz, Khr, Chr, Xu, Xu, Xu, Xu, Xos
Xu, Xu, Cuay, Cuay, Urfz, Urfz, Urfz, Urfz, Chr, Chr, Xu, Xu, Xu, Xos
Xu, Xu, Xu, Xu, Xu, Urfz^Bryl, Xu, Xu, Xu, Xu, Xu, Xu, Xu, Xos
Xu, Xu, Xu, Xu, Xu, Xu, Xu, Xu, Xu, Xu, Xos, Xu, Xos, Xos
