Xos, Xos, Xom, Xom, Xom, Xom, Xom, Xos, Xom, Xom, Xom, Xos, Xos, Xos
Xos, Xom, Ce, Ce, Ce, Ce, Ce, Xom, Ce, Ce, Xos, Xos, Xos, Xos
Xos, Xom, Ce, Ce, Ce, Ce, Ce, Ce, Xos, Xos, Iwr^Taby, Xos, Xos, Xos
Xos, Xom, Ce, Ce, Iwr^Taby, Iwr^Taby, Iwr^Taby, Iwr^Taby, Xos, Iwr, Iwr, Iwr, Iwr, Xos
Xos, Xos, Iwr, Iwr, Iwr, Iwr, Iwr, Iwr, Iwr, Iwr, Iwr^Taby, Iwr, Xos, Xos
Xos, Iwr, Iwr^Taby, Iwr, Iwr^Taby, Iwr, Re, Iwr, Iwr^Taby, Iwr, Iwr, Xos, Xos, Xos
Xos, Xos, Xos, Iwr, Re, Re, Re, Iwr^Taby, Re, Iwr, Re, Iwr^Taby, Xos, Xos
Xos, Xos, Xos, Xos, Re, Re, Re, Re, Re, Re, Iwr, Iwr, Xos, Xos
Xos, Xos, Xos, Re, Re, Re, Ce, Re, Re, Re, Re, Iwr, Xos, Xos
Xos, Xos, Xos, Xos, Iwr, Ce, 1 Ke, Ce, Iwr, Re, Xos, Xos, Xos, Xos
Xos, Xos, Xos, Xos, Re, Ce, Ce, Ce, Re, Xos, Xos, Xos, Xos, Xos
Xos, Xos, Xos, Xos, Re, Re, Rb, Re, Rb, Xos, Xos, Xos, Xos, Xos
Xos, Xos, Xos, Xos, Rb, Rb, Rb, Rb, Aa, Xos, Xos, Xos, Xos, Xos
Xos, Xos, Xos, Xos, Xos, Aa, Aa, Aa, Aa, Xos, Xos, Xos, Xos, Xos
