Uu, Xu, Xu, Uu, Ur, Uu, Urb, Urb, Urb, Urb, Urb, Rb^Uf, Rb^Uf, Rb^Uf, Xu, Xu, Xu, Uu, Uu^Vu, Uu, Uu, Xu
Xu, Xu, Xu, Uu, Xu, Ur, Ur, Rb, Rb, Rb, Urb, Rb^Uf, Rb^Uf, Rb^Uf, Xu, Xu, Xu, Xu, 1 Uu, Xu, Xu, Xu
Xu, Xu, Uh, Uu, Uu, Ur, Xu, Rb, Uu, Uu, Rb, 2 Rb, Rb^Uf, Uu, Uu, Xu, Xu, Xu, Xu, Xu, Xu, Xu
Xu, Xu, Uu, Ur, Ur, Uu, Xu, Uu, Xu, Uu^Uf, Uu, Ur, Rb, Rb, Uu, Uu, Uh, Xu, Uh, Uu, Xu, Xu
Xu, Uh, Uu, Ur, Uu, Xu, Xu, Xu, Xu, Xu, Uu, Uu, Ur, Rb, Urb, Uu, Uu, Uu, Uu, Uu, Uu, Xu
Xu, Uu, Uu, Ur, Uu, Xu, Xu, Xu, Qxu, Xu, Uu, Uu, Ur, Urb, Urb, Xu, Xu, Xu, Uu, Ur, Uu, Uu
Uh, Rb, Rb, Uu, Xu, Xu, Xu, Xu, Uu, Ur, Xyom, Uu, Uu, Urb, Urb, Urb, Uu, Uu, Xu, Uu, Ur, Ur
Rb, Uu, Uu, Xu, Xu, Xu, Xu, Xu, Ur, Uu, Uu, Xyom, Uu, Rb, Rb, Uu, Xyom, Uu, Uu, Xu, Uu, Uu
Uu, Uu, Uu, Xu, Xu, Xu, Xyom, Xyom, Xyom, Ur, Uu, Xyom, Uu, Rb, Uu, Uu, Xyom, Xyom, Xu, Xu, Xu, Xu
Uu, Xu, Xu, Xu, Uu, Xyom, Uu, Xyom, Uu, Ur, Brym, Cpy, Brym, Rb, Uu, Uu, Uu, Xyom, Xos, Xu, Xu, Xu
Rb, Rb, Uh, Uh, Xyom, Uu, Uu, Uu, Brym, Brym, Mybd, Mybd, Mybd, Brym, Brym, Uu^Uf, Uu, Xyom, Xu, Xos, Xu, Uu
Xu, Xu, Uu, Uu, Xyom, Urb, Brym, Brym, Mybd, Mybd, Myb, Myb, Myb, Mybd, Mybd, Brym, Uu, Uu, Uh, Xos, Uu, Ur
Xu, Xu, Uu, Xyom, Xu, Urb, Xyom, Cmy, Mybd, Myb, Myb, Myb, Myb, Myb, Mybd, Cmy, Uu, Xyom, Uu, Uu^Uf, Ur, Uu
Xu, Xu, Ur, Ur, Rb, Urb, Xyom, Brym, Brym, Mybd, Mybd, Myb, Mybd, Mybd, Brym, Brym, Uu, Xyom, Rb, Uu, Xu, Xu
Xu, Rb, Ur, Uu, Xos, Urb, Rb^Uf, Uu, Xyom, Brym, Brym, Mybd, Brym, Brym, Xyom, Urb, Xos, Uu, Urb, Uu, Xu, Xu
Rb, Xu, Ur, Xos, Xos, Urb, Rb^Uf, Xyom, Uu^Vu, Uu, Xos, Brym, Urb, Uu, Xyom, Urb, Xos, Uu, Urb, Uu, Xu, Xu
Xu, Xu, Ur, Xos, Xu, Urb, Xos, Xos, Uu, Xos, Xu, Uh, Urb, Uu, Uu, Xos, Xos, Rb, Urb, Uu, Xu, Xu
Uu, Xu, Uu, Uu, Urb, Urb, Xu, Xu, Uu, Xos, Uu, Uh, Xu, Xu, Uu^Vu, Xu, Xu, Urb, Uh, Uh, Xu, Xu
Uu, Xu, Rb^Uf, Uu, Urb, Urb, Xu, Xu, Uu, Uu, Uu, Urb, Xu, Uu, Uu, Xu, Xu, Ur, Uh, Uu, Xu, Ur
Xu, Xu, Uu, Uu, Urb, Xu, Uh, Uh, Xu, Urb, Xu, Xu, Xu, Xu, Rb, Xu, Xu, Ur, Ur, Uu, Ur, Ur
Xu, Xu, Uu, Uu, Urb, Xu, Uh, Uh, Xu, Urb, Xu, Xu, Urb, Urb, Xu, Xu, Xu, Uu, Ur, Ur, Ur, Uu
Xu, Xu, Ur, Uu, Uu, Rb, Xu, Xu, Uu, Urb, Xu, Rb, Uu, Xu, Xu, Xu, Uu, Ur, Ur, Uu, Uu, Uu
