border_size=1
usage=map

Ms^Xm, Ms^Xm, Ms^Xm, Ha, Ms^Xm, Ha, Ms^Xm, Ms^Xm, Ms^Xm, Ms^Xm, Ms^Xm, Ms^Xm, Ms^Xm, Ms^Xm, Ms^Xm, Ms^Xm, Ms^Xm, Mm, Rp, Rp, Rp, Rp, Ur, Uh, Ql, Uh, Uh, Mm, Mm, Ha, Ms^Xm, Ha, Ms^Xm, Ha, Ms^Xm, Ms^Xm, Ms^Xm, Ha, Ms^Xm, Ha, Ms^Xm, Ha, Ms^Xm, Ms^Xm, Ms^Xm, Ha
Aa, Ms, Ms, Ms^Xm, Ms, Ms^Xm, Ms, Ms, Ms, Ms, Ms, Ms, Ms, Ms^Xm, Ms, Ms^Xm, Aa^Voa, Rp, Rp, Rp, Rp, Rp, Ur, Uh, Uh, Uh, Ur, Aa, Ms, Ms^Xm, Ms, Ms^Xm, Ms, Ms^Xm, Ms, Ms^Xm, Ms, Ms^Xm, Ms^Xm, Ms^Xm, Ms^Xm, Ms^Xm, Ms^Xm, Ms^Xm, Ms^Xm, Ms^Xm
Aa, Aa, Aa, Ms, Aa, Ms, Ms, Ms, Ha, Ms, Ha, Ms, Ms, Ms, Ms, Ms, Aa, Aa, Rd, Rp, Coa, Coa, 2 Koa, Ur^Dr, Ur^Dr, Ur, Coa, Aa, Aa, Ms, Ms, Ms, Ms, Ms, Ms, Ms, Ms, Ms, Ms, Ms^Xm, Ms^Xm, Ms^Xm, Ms^Xm, Ms^Xm, Ms^Xm, Ms^Xm
Ywsd, Ywsd, Ywsd, Aa, Aa, Aa, Ms, Ha, Ha, Ha, Ha, Ha, Ha, Ms, Ha, Ha, Aa, Aa, Rd, Rd, Coa, Coa, Coa, Rp^Dr, Aa, Aa, Aa, Aa, Aa, Ha, Ha, Ha, Ha, Ha, Ha, Ha, Aa, Ms, Ha, Ms, Ms, Ms^Xm, Ms^Xm, Ms^Xm, Ms^Xm, Ms^Xm
Ywsd, Ywsd, Ywsd, Ywsd, Ywsd, Aa, Aa, Ms, Ha, Aa^Fpa, Ha, Ha, Ha, Ha, Aa, Ha, Aa, Aa^Voa, Re, Rd, Aa, Aa, Aa, Aa, Aa, Aa, Aa, Aa, Aa, Aa, Aa, Aa, Aa, Ha, Aa, Aa, Aa, Aa, Aa, Ha, Ms, Ms, Ms, Ms^Xm, Ms^Xm, Ms^Xm
Ywsd, Ywsd, Ywsd, Ywsd, Ywsd, Aa, Aa, Ha, Ha, Ha, Aa^Fpa, Aa^Fpa, Aa, Aa^Fpa, Aa, Aa, Aa, Aa, Re, Spay, Aa, Aa, Aa, Aa, Aa, Aa, Aa, Aa, Aa^Fpa, Aa, Aa, Aa, Aa, Aa, Aa, Aa, Dyb, Dyb, Dyb, Aa, Ha, Ms, Ms, Ms, Ms, Ms^Xm
Ywsd, Ywsd, Ywsd, Ywsd, Ywsd, Aa, Aa, Aa, Aa^Fpa, Ha, Ha, Aa^Fpa, Aa, Aa, Aa, Aa, Aa, Aa, Spay, Spay, Aa, Aa, Aa, Aa^Fpa, Aa, Aa, Aa, Aa, Aa^Fpa, Ha, Ha, Aa, Aa, Aa, Aa, Aa, Aa, Dyb, Aa, Aa, Aa, Ha, Ha, Ms, Ms, Ms
Ywsd, Ywsd, Ywsd, Ywsd, Ywsd, Ywsd, Ywsd, Aa, Aa, Aa^Fpa, Aa^Fpa, Aa^Fpa, Aa, Aa, Aa, Aa, Aa, Aa, Aa, Spay, Aa, Aa, Aa, Aa, Aa, Aa, Aa, Aa, Aa, Ha, Aa, Aa, Aa, Aa, Aa, Aa, Aa, Aa, Aa, Aa, Dyb, Aa, Aa, Ha, Ms, Ms
Ywsd, Ywsd, Ywsd, Ywsd, Ywsd, Ywsd, Ywsd, Aa, Aa, Aa, Aa, Aa, Aa, Aa, Aa, Aa, Aa, Aa, Aa^Fpa, Spay, Spay, Aa, Aa, Aa, Aa, Aa, Aa, Aa, Aa, Aa, Aa, Aa, Ywsd, Ywsd, Ywsd, Aa, Ywsd, Aa, Aa, Dyb, Dyb, Dyb, Aa, Ha, Ms, Ms
Ywsd, Ywsd, Ywsd, Ywsd, Ywsd, Ywsd, Ywsd, Ywsd, Ywsd, Aa, Aa, Aa, Aa, Aa, Aa, Aa, Aa^Fpa, Aa^Fpa, Aa, Spay, Spay, Aa, Aa, Aa, Aa, Aa, Aa, Aa, Aa, Aa, Ywsd, Ywsd, Ywsd, Ywsd, Ywsd, Aa, Aa, Aa, Aa, Aa, Dyb, Aa, Aa, Ha, Ha, Ms
Ywsd, Ywsd, Ywsd, Ywsd, Ywsd, Ywsd, Ywsd, Ywsd, Ywsd, Ywsd, Ywsd, Aa, Aa, Aa, Aa, Aa^Fpa, Tyb, Tyb, Aa, Aa^Fpa, Spay, Spay, Spay, Aa, Aa, Aa, Aa, Aa, Aa, Aa, Ywsd, Ywsd, Ywsd, Ywsd, Ywsd, Aa, Aa, Aa, Aa, Dyb, Dyb, Dyb, Aa, Aa, Ha, Ms
Ywsd, Ywsd, Ywsd, Ywsd, Ywsd, Ywsd, Ywsd, Ywsd, Ywsd, Ywsd, Ywsd, Aa, Aa, Aa, Aa, Aa^Fpa, Aa^Fpa, Tyb, Aa^Fpa, Spay, Ha, Ha, Ha, Spay, Spay, Aa, Aa, Aa, Aa, Aa, Ywsd, Ywsd, Ywsd, Ywsd, Ywsd, Ywsd, Ywsd, Aa, Aa, Aa, Aa, Aa, Aa, Aa, Aa, Ha
Ywsd, Ywsd, Ywsd, Ywsd, Ywsd, Ywsd, Ywsd, Ywsd, Ywsd, Ywsd, Ywsd, Ywsd, Aa, Aa, Aa, Aa, Aa, Aa^Fpa, Spay, Spay, Ha, Ha, Aa, Spay, Spay, Aa, Aa, Aa, Aa, Aa, Ywsd, Ywsd, Ywsd, Ywsd, Ywsd, Ywsd, Ywsd, Ywsd, Ywsd, Ywsd, Ywsd, Aa, Aa, Aa, Aa, Ha
Ywsd, Ywsd, Ywsd, Ywsd, Ywsd, Ywsd, Ywsd, Ywsd, Ywsd, Ywsd, Ywsd, Aa, Aa, Aa, Aa, Aa, Spay, Spay, Aa, Aa, Aa, Ha, Aa, Aa, Spay, Aa, Aa, Aa, Ywsd, Ywsd, Ywsd, Ywsd, Ywsd, Ywsd, Ywsd, Ywsd, Ywsd, Ywsd, Ywsd, Ywsd, Ywsd, Ywsd, Aa, Aa, Aa, Ha
Ywsd, Ywsd, Ywsd, Ywsd, Ywsd, Ywsd, Ywsd, Ywsd, Ywsd, Ywsd, Aa, Aa, Dyb, Dyb, Dyb, Aa, Spay, Spay, Aa, Aa, Aa, Aa, Aa, Aa, Spay, Aa, Aa, Aa, Aa, Ywsd, Ywsd, Ywsd, Ywsd, Ywsd, Ywsd, Ywsd, Ywsd, Ywsd, Ywsd, Ywsd, Ywsd, Ywsd, Ywsd, Aa, Aa, Ha
Ywsd, Ywsd, Ywsd, Ywsd, Ywsd, Ywsd, Ywsd, Ywsd, Aa, Aa, Aa, Aa, Aa, Aa, Aa, Aa, Aa^Fpa, Aa, Aa, Aa, Aa, Aa, Aa, Aa, Spay, Aa, Aa, Aa, Ywsd, Ywsd, Ywsd, Ywsd, Ywsd, Ywsd, Ywsd, Ywsd, Ywsd, Ywsd, Ywsd, Ywsd, Ywsd, Ywsd, Ywsd, Aa, Aa, Ha
Ywsd, Ywsd, Ywsd, Ywsd, Ywsd, Ywsd, Aa, Aa, Aa, Aa, Aa, Aa, Aa, Aa, Aa, Aa^Fpa, Tyb, Aa^Fpa, Aa^Fpa, Aa, Aa, Aa, Aa, Aa, Spay, Aa, Aa, Aa, Ywsd, Ywsd, Ywsd, Ywsd, Ywsd, Ywsd, Ywsd, Ywsd, Ywsd, Ywsd, Ywsd, Ywsd, Ywsd, Ywsd, Ywsd, Ywsd, Aa, Aa
Ywsd, Ywsd, Ywsd, Ywsd, Ywsd, Aa, Aa, Aa, Ha, Ha, Ha, Aa, Aa, Aa, Aa^Fpa, Tyb, Tyb, Tyb, Aa, Aa, Aa, Aa, Spay, Spay, Aa, Aa, Ywsd, Ywsd, Ywsd, Ywsd, Ywsd, Ywsd, Ywsd, Ywsd, Ywsd, Ywsd, Ywsd, Ywsd, Ywsd, Ywsd, Ywsd, Ywsd, Ywsd, Ywsd, Ywsd, Aa
Ywsd, Ywsd, Ywsd, Ywsd, Ywsd, Aa, Aa, Aa, Aa, Ha, Aa, Aa, Aa, Aa, Aa, Tyb, Tyb, Tyb, Aa, Aa, Aa, Aa, Aa, Aa, Aa, Aa, Ywsd, Ywsd, Ywsd, Ywsd, Ywsd, Ywsd, Ywsd, Ywsd, Ywsd, Ywsd, Ywsd, Ywsd, Ywsd, Ywsd, Ywsd, Ywsd, Ywsd, Ywsd, Ywsd, Ywsd
Ywsd, Ywsd, Ywsd, Ywsd, Ywsd, Ywsd, Ywsd, Aa, Aa, Aa, Aa, Aa, Aa, Aa, Aa, Aa^Fpa, Aa^Fpa, Aa, Aa, Aa, Aa, Aa, Aa, Aa, Ywsd, Ywsd, Ywsd, Ywsd, Ywsd, Ywsd, Ywsd, Ywsd, Ywsd, Ywsd, Ywsd, Ywsd, Ywsd, Ywsd, Ywsd, Ywsd, Ywsd, Ywsd, Ywsd, Ywsd, Ywsd, Ywsd
Ywsd, Ywsd, Ywsd, Ywsd, Ywsd, Ywsd, Ywsd, Aa, Aa, Aa, Aa, Aa, Aa, Aa, Aa, Aa, Spay, Aa, Aa, Aa, Aa, Aa, Dyb, Aa, Ywsd, Ywsd, Ywsd, Ywsd, Ywsd, Ywsd, Ywsd, Ywsd, Ywsd, Ywsd, Ywsd, Ywsd, Ywsd, Ywsd, Ywsd, Ywsd, Ywsd, Ywsd, Ywsd, Ywsd, Ywsd, Ywsd
Ywsd, Ywsd, Ywsd, Ywsd, Ywsd, Ywsd, Ywsd, Ywsd, Aa, Dyb, Dyb, Aa, Aa, Aa, Spay, Spay, Aa, Aa, Aa, Aa, Dyb, Dyb, Aa, Ywsd, Ywsd, Ywsd, Ywsd, Ywsd, Ywsd, Ywsd, Ywsd, Ywsd, Ywsd, Ywsd, Ywsd, Ywsd, Ywsd, Ywsd, Ywsd, Ywsd, Ywsd, Ywsd, Ywsd, Ywsd, Ywsd, Ywsd
Ywsd, Ywsd, Ywsd, Ywsd, Ywsd, Ywsd, Ywsd, Ywsd, Aa, Aa, Aa, Aa, Spay, Spay, Aa, Aa, Dyb, Aa, Aa, Aa, Aa, Aa, Ywsd, Ywsd, Ywsd, Ywsd, Ywsd, Ywsd, Ywsd, Ywsd, Ywsd, Ywsd, Ywsd, Ywsd, Ywsd, Ywsd, Ywsd, Ywsd, Ywsd, Ywsd, Ywsd, Ywsd, Ywsd, Ywsd, Ywsd, Ywsd
Ywsd, Ywsd, Ywsd, Ywsd, Ywsd, Ywsd, Ywsd, Aa, Aa, Aa, Spay, Spay, Aa, Aa, Aa, Aa, Aa, Aa, Ha, Aa, Aa, Aa, Aa, Ywsd, Ywsd, Ywsd, Ywsd, Ywsd, Ywsd, Ywsd, Ywsd, Ywsd, Ywsd, Ywsd, Ywsd, Ywsd, Ywsd, Ywsd, Ywsd, Ywsd, Ywsd, Ywsd, Ywsd, Ywsd, Ywsd, Ywsd
Ywsd, Ywsd, Ywsd, Ywsd, Ywsd, Ywsd, Ywsd, Aa, Aa, Aa, Spay, Spay, Aa, Aa, Ms, Ms, Ms, Ms, Ha, Ha, Aa, Aa, Aa, Aa, Ywsd, Ywsd, Ywsd, Ywsd, Ywsd, Ywsd, Ywsd, Ywsd, Ywsd, Ywsd, Ywsd, Ywsd, Ywsd, Ywsd, Ywsd, Ywsd, Ywsd, Ywsd, Ywsd, Ywsd, Ywsd, Ywsd
Ywsd, Ywsd, Ywsd, Ywsd, Ywsd, Ywsd, Ywsd, Aa, Aa, Aa, Ms, Ms, Ms, Ms, Ha, Ha, Ha, Ha, Aa, Aa, Ha, Aa, Aa, Aa, Aa, Ywsd, Ywsd, Ywsd, Ywsd, Ywsd, Ywsd, Ywsd, Ywsd, Ywsd, Ywsd, Ywsd, Ywsd, Ywsd, Ywsd, Ywsd, Ywsd, Ywsd, Ywsd, Ywsd, Ywsd, Ywsd
Ywsd, Ywsd, Ywsd, Ywsd, Ywsd, Ywsd, Aa, Aa, Aa, Spay, Ms, Aa, Rrc, Spay, Aa, Ha, Aa^Voa, Ha, Aa, Ha, Ha, Aa, Aa, Aa, Aa, Dyb, Aa, Aa, Aa, Aa, Aa, Ywsd, Aa, Ywsd, Ywsd, Ywsd, Ywsd, Ywsd, Ywsd, Ywsd, Ywsd, Ywsd, Ywsd, Ywsd, Ywsd, Ywsd
Ywsd, Ywsd, Ywsd, Ywsd, Ywsd, Ywsd, Ywsd, Aa, Aa, Spay, Ms, Rrc, Ms, Rrc, Rrc, Aa, Aa, Aa, Aa, Ha, Rrc, Ha, Rrc, Aa, Spay, Aa, Aa, Aa, Aa, Aa, Aa^Fpa, Aa, Aa, Aa, Aa, Aa, Aa, Ywsd, Ywsd, Ywsd, Ywsd, Ywsd, Ywsd, Ywsd, Ywsd, Ywsd
Ywsd, Ywsd, Ywsd, Ywsd, Ywsd, Ywsd, Aa, Aa, Aa, Spay, Spay, Rrc, Ms, Spay, Aa, Rrc, Rrc, Coa, Rrc, Rrc, Rrc, Rrc, Aa, Rrc, Spay, Aa, Aa, Aa^Fpa, Tyb, Tyb, Tyb, Aa, Aa, Dyb, Dyb, Aa, Aa, Ywsd, Aa, Ywsd, Aa, Ywsd, Aa, Aa, Aa, Aa
Ywsd, Ywsd, Ywsd, Ywsd, Ywsd, Ywsd, Ywsd, Aa, Aa, Aa, Ms^Xm, Ms, Ha, Ha, Ha, Aa^Voa, Aa, Koa, Coa, Aa, Ha, Ha, Ha, Aa, Aa, Spay, Aa^Fpa, Tyb, Tyb, Tyb, Tyb, Aa^Fpa, Aa, Aa, Aa, Aa, Dyb, Aa, Dyb, Aa, Aa, Aa, Aa, Aa, Aa, Aa
Ywsd, Ywsd, Ywsd, Ywsd, Ywsd, Ywsd, Ywsd, Ywsd, Aa, Ha, Ms^Xm, Ha, Ha, Ha, Ha, Ha, Ha, Aa, Aa, Aa, Ha, Ms, Ha, Aa, Aa, Spay, Aa, Tyb, Tyb, Tyb, Aa^Fpa, Aa^Fpa, Spay, Aa, Aa, Aa, Aa, Aa, Aa, Dyb, Aa, Aa, Ms, Ms, Ms, Aa
Ywsd, Ywsd, Ywsd, Ywsd, Ywsd, Ywsd, Ywsd, Aa, Aa, Ms, Ms, Ms^Xm, Ms^Xm, Ha, Ha, Ha, Ha, Ha, Aa^Fpa, Aa^Voa, Aa, Ha, Aa, Aa, Aa, Aa, Aa, Aa^Fpa, Aa, Aa, Aa, Spay, Spay, Spay, Spay, Spay, Aa, Aa, Aa, Aa, Ha, Ha, Ha, Ms, Ms, Ms
Ywsd, Ywsd, Ywsd, Ywsd, Ywsd, Ywsd, Ywsd, Aa, Aa, Ha, Aa, Ms, Ms, Ms^Xm, Ms^Xm, Ms, Ms^Xm, Ha, Ms, Aa^Fpa, Ms, Aa, Aa, Aa, Aa, Aa, Aa, Ha, Ha, Aa, Aa, Aa, Aa, Aa, Aa, Spay, Aa, Aa, Aa, Aa, Ha, Ha, Aa^Voa, Ms, Ms, Ms
Ywsd, Ywsd, Ywsd, Ywsd, Ywsd, Ywsd, Ywsd, Ywsd, Ywsd, Aa, Ywsd, Aa, Aa, Ha, Ha, Ms^Xm, Aa, Ms^Xm, Aa, Ms, Aa, Aa, Aa, Aa, Aa, Aa, Ha, Ha, Ha, Aa, Ha, Ha, Ha, Aa, Aa, Aa, Aa, Spay, Spay, Aa, Aa, Aa, Aa, Aa, Ms, Ms
Ywsd, Ywsd, Ywsd, Ywsd, Ywsd, Ywsd, Ywsd, Ywsd, Ywsd, Ywsd, Ywsd, Ywsd, Ywsd, Aa, Aa, Aa, Aa, Aa, Aa, Aa, Aa, Aa, Aa, Ha, Ha, Ha, Ms, Ha, Ha, Ha, Ai, Ha, Ai, Ai, Ai, Aa, Ai, Aa, Aa, Aa, Aa, Aa, Aa, Aa, Aa, Aa
Ywsd, Ywsd, Ywsd, Ywsd, Ywsd, Ywsd, Ywsd, Ywsd, Ywsd, Ywsd, Ywsd, Ywsd, Ywsd, Ywsd, Aa, Aa, Aa, Aa, Aa, Aa, Ai, Aa, Ai, Ha, Ha, Ms, Ms, Ha, Ai, Ai, Wo, Ai, Wo, Wo, Ai, Ai, Ai, Ai, Aa^Fpa, Aa^Fpa, Aa^Fpa, Aa, Aa, Dyb, Aa, Aa
Ywsd, Ywsd, Ywsd, Ywsd, Ywsd, Ywsd, Ywsd, Ywsd, Ywsd, Ywsd, Ywsd, Ywsd, Ywsd, Ywsd, Ywsd, Aa, Aa, Ymsd, Aa, Ai, Wo, Wo, Wo, Ai, Wo, Ha, Ai, Ha, Wo, Wo, Wo, Wo, Uh, Wo, Wo, Wo, Ai, Aa^Fpa, Tyb, Tyb, Tyb, Aa^Fpa, Aa, Aa, Aa, Aa
Ywsd, Ywsd, Ywsd, Ywsd, Ywsd, Ywsd, Ywsd, Ywsd, Ywsd, Ywsd, Ywsd, Ywsd, Aa, Ywsd, Ywsd, Ywsd, Aa, Aa, Aa, Ai, Ai, Wo, Ai, Wo, Wo, Wo, Wo, Wo, Wo, Wo, Uu, Uu, Ql, Uh, Wo, Ai, Aa, Aa^Fpa, Tyb, Tyb, Tyb, Aa^Fpa, Aa, 3 Aa, Aa, Aa
Ywsd, Ywsd, Ywsd, Ywsd, Ywsd, Ywsd, Ywsd, Ywsd, Ywsd, Ywsd, Ywsd, Aa, Aa, Aa, Aa, Aa, Aa, Aa, Aa, Aa, Ha, Aa, Ha, Ha, Ha, Ai, Ha, Ai, Ai, Wo, Wo, Uh, Uh, Uh, Wo, Ai, Aa, Aa, Aa, Tyb, Aa, Aa^Fpa, Aa, Aa, Aa, Aa
Ywsd, Ywsd, Ywsd, Ywsd, Ywsd, Ywsd, Ywsd, Ywsd, Ywsd, Ywsd, Ywsd, Aa, Aa, Aa, Aa, Aa, Ha, Aa, Ha, Ha, Ms, Ha, Ms^Xm, Ha, Ms^Xm, Ha, Ha, Ai, Ai, Ai, Ai, Wo, Wo, Uu, Wo, Ai, Re, Spay, Aa, Aa, Aa, Aa, Aa, Aa, Aa, Aa
Ywsd, Ywsd, Ywsd, Ywsd, Ywsd, Ywsd, Ywsd, Ywsd, Ywsd, Ywsd, Ywsd, Aa, Aa, Dyb, Aa, Ha, Ms, Ha, Ha, Ha, Ms, Ms^Xm, Ms^Xm, Ms^Xm, Ms^Xm, Ms^Xm, Ms^Xm, Ha, Ha, Ai, Ai, Wo, Wo, Wo, Ai, Ai, Re, Spay, Aa, Dyb, Aa, Aa, Aa, Dyb, Aa, Aa
Ywsd, Ywsd, Ywsd, Ywsd, Ywsd, Ywsd, Ywsd, Ywsd, Ywsd, Ywsd, Ywsd, Ywsd, Aa, Aa, Aa, Ha, Ha, Ms, Ms, Ms, Ms, Ms, Ms, Ms, Ms, Ms, Ms, Ms^Xm, Ha, Ha, Re, Ai, Ai, Ai, Aa, Re, Aa, Aa, Aa, Aa, Aa, Aa, Ywsd, Aa, Ywsd, Aa
Ywsd, Ywsd, Ywsd, Ywsd, Ywsd, Ywsd, Ywsd, Ywsd, Ywsd, Ywsd, Aa, Aa, Aa, Aa, Aa, Ha, Ha, Ha, Ha, Ms, Ms, Ms, Ms, Ms, Ms^Xm, Ms^Xm, Ms, Ms, Ha, Spay, Spay, Aa, Aa, Aa, Aa, Spay, Aa, Aa, Aa, Aa, Ywsd, Ywsd, Ywsd, Ywsd, Ywsd, Ywsd
Ywsd, Ywsd, Ywsd, Ywsd, Ywsd, Ywsd, Ywsd, Ywsd, Ywsd, Aa, Aa, Aa, Aa, Aa, Aa, Ha, Ha, Ha, Ha, Ha, Ha, Ms, Ms, Ms, Ms, Ms, Ha, Ha, Spay, Spay, Spay, Aa, Aa, Aa, Aa, Aa, Aa, Aa, Ywsd, Ywsd, Ywsd, Ywsd, Ywsd, Ywsd, Ywsd, Ywsd
Ywsd, Ywsd, Ywsd, Ywsd, Ywsd, Ywsd, Ywsd, Ywsd, Ywsd, Aa, Aa, Aa, Aa, Aa, Aa, Aa, Aa, Ha, Ha, Ha, Ha, Ms, Ha, Ms, Ms, Ha, Aa^Voa, Aa, Aa^Fpa, Aa, Aa, Aa, Aa, Aa, Aa, Aa, Ywsd, Ywsd, Ywsd, Ywsd, Ywsd, Ywsd, Ywsd, Ywsd, Ywsd, Ywsd
Ywsd, Ywsd, Ywsd, Ywsd, Ywsd, Ywsd, Ywsd, Ywsd, Ywsd, Ywsd, Ywsd, Aa, Aa, Dyb, Aa, Aa, Aa, Aa, Aa, Ha, Ha, Ha, Spay, Ha, Ha, Ha, Aa, Aa, Tyb, Tyb, Aa^Fpa, Aa, Aa, Ywsd, Ywsd, Ywsd, Ywsd, Ywsd, Ywsd, Ywsd, Ywsd, Ywsd, Ywsd, Ywsd, Ywsd, Ywsd
Ywsd, Ywsd, Ywsd, Ywsd, Ywsd, Ywsd, Ywsd, Ywsd, Ywsd, Ywsd, Ywsd, Aa, Aa, Aa, Aa^Fpa, Aa^Fpa, Aa, Spay, Spay, Aa, Aa, Aa, Aa, Spay, Spay, Ha, Aa, Aa^Fpa, Tyb, Tyb, Aa^Fpa, Aa, Aa, Ywsd, Ywsd, Ywsd, Ywsd, Ywsd, Ywsd, Ywsd, Ywsd, Ywsd, Ywsd, Ywsd, Ywsd, Ywsd
Ywsd, Ywsd, Ywsd, Ywsd, Ywsd, Aa, Aa, Aa, Aa, Aa, Aa, Aa, Aa, Aa^Fpa, Tyb, Tyb, Aa^Fpa, Spay, Spay, Aa, Aa, Dyb, Aa, Aa, Aa, Spay, Aa, Aa, Aa^Fpa, Aa^Fpa, Aa, Aa, Ywsd, Ywsd, Ywsd, Ywsd, Ywsd, Ywsd, Ywsd, Ywsd, Ywsd, Ywsd, Ywsd, Ywsd, Ywsd, Ywsd
Ywsd, Ywsd, Ywsd, Ywsd, Ywsd, Ywsd, Ywsd, Aa, Aa, Aa, Aa, Aa, Aa, Aa^Fpa, Tyb, Tyb, Tyb, Aa, Aa, Aa, Aa, Aa, Aa, Aa, Aa, Spay, Aa, Aa, Aa, Aa, Dyb, Aa, Aa, Ywsd, Ywsd, Ywsd, Ywsd, Ywsd, Ywsd, Ywsd, Ywsd, Ywsd, Ywsd, Ywsd, Ywsd, Ywsd
Ywsd, Ywsd, Ywsd, Ywsd, Aa, Aa, Aa, Aa, Aa, Aa, Aa, Aa, Aa, Aa^Fpa, Aa^Fpa, Tyb, Aa^Fpa, Aa, Aa, Aa, Aa, Aa, Ha, Aa^Fpa, Ha, Aa, Aa, Aa, Ha, Aa, Aa, Aa, Ywsd, Ywsd, Ywsd, Ywsd, Ywsd, Ywsd, Ywsd, Ywsd, Ywsd, Ywsd, Ywsd, Ywsd, Ywsd, Ywsd
Ywsd, Ywsd, Ywsd, Ywsd, Ywsd, Aa, Aa, Aa, Aa, Aa, Aa, Aa, Aa, Aa, Spay, Aa^Fpa, Aa, Dyb, Dyb, Aa, Ha^Fpa, Ha, Ha, Ha, Ms^Xm, Ms^Xm, Ms^Xm, Ha, Ha, Ha, Aa, Ywsd, Ywsd, Ywsd, Ywsd, Ywsd, Ywsd, Ywsd, Ywsd, Ywsd, Ywsd, Ywsd, Ywsd, Ywsd, Ywsd, Ywsd
Ywsd, Ywsd, Ywsd, Ywsd, Ywsd, Ywsd, Aa, Aa, Aa, Aa, Aa, Dyb, Aa, Aa, Aa, Spay, Aa, Aa, Aa, Aa, Ha, Ha, Ms, Ms, Ms, Ms, Ms, Ms, Ms, Ha, Ywsd, Ywsd, Ywsd, Ywsd, Ywsd, Ywsd, Ywsd, Ywsd, Ywsd, Ywsd, Ywsd, Ywsd, Ywsd, Ywsd, Ywsd, Ywsd
Ywsd, Ywsd, Ywsd, Ywsd, Ywsd, Aa, Aa, Aa, Aa, Aa, Aa, Aa, Aa, Aa, Aa, Aa, Aa, Aa, Aa, Aa, Ha, Ha, Ha, Ha, Ha, Ha, Aa, Ha, Aa, Ha, Ywsd, Ywsd, Ywsd, Ywsd, Ywsd, Ywsd, Ywsd, Ywsd, Ywsd, Ywsd, Ywsd, Ywsd, Ywsd, Ywsd, Ywsd, Ywsd
Ywsd, Ywsd, Ywsd, Ywsd, Ywsd, Ywsd, Ywsd, Aa, Ywsd, Aa, Aa, Aa, Aa, Aa, Aa, Aa, Aa, Spay, Spay, Aa, Aa, Ha, Aa, Ha, Aa, Aa, Aa, Aa, Ywsd, Ywsd, Ywsd, Ywsd, Ywsd, Ywsd, Ywsd, Ywsd, Ywsd, Ywsd, Ywsd, Ywsd, Ywsd, Ywsd, Ywsd, Ywsd, Ywsd, Ywsd
Ywsd, Ywsd, Ywsd, Ywsd, Ywsd, Ywsd, Ywsd, Ywsd, Ywsd, Ywsd, Ywsd, Ywsd, Ywsd, Aa, Aa, Aa, Aa, Aa, Aa, Spay, Spay, Aa, Aa, Aa, Aa, Aa, Aa, Aa, Aa, Ywsd, Aa, Ywsd, Ywsd, Ywsd, Ywsd, Ywsd, Ywsd, Ywsd, Ywsd, Ywsd, Ywsd, Ywsd, Ywsd, Ywsd, Ywsd, Ywsd
Ywsd, Ywsd, Ywsd, Ywsd, Ywsd, Ywsd, Ywsd, Ywsd, Ywsd, Ywsd, Ywsd, Ywsd, Ywsd, Ywsd, Aa, Aa, Aa, Aa, Aa, Aa, Aa, Aa^Fpa, Tyb, Aa^Fpa, Aa, Aa, Aa, Aa, Aa, Aa, Aa, Ywsd, Ywsd, Ywsd, Ywsd, Ywsd, Ywsd, Ywsd, Ywsd, Ywsd, Ywsd, Ywsd, Ywsd, Ywsd, Ywsd, Ywsd
Ywsd, Ywsd, Ywsd, Ywsd, Ywsd, Ywsd, Ywsd, Ywsd, Ywsd, Ywsd, Ywsd, Ywsd, Ywsd, Ywsd, Ywsd, Aa, Aa, Aa, Aa, Aa^Fpa, Aa, Aa^Fpa, Aa^Fpa, Tyb, Aa^Fpa, Aa, Aa, Aa, Aa, Aa, Aa, Ywsd, Aa, Ywsd, Aa, Ywsd, Aa, Aa, Aa, Ywsd, Aa, Ywsd, Aa, Aa, Aa, Aa
Ywsd, Ywsd, Ywsd, Ywsd, Ywsd, Ywsd, Ywsd, Ywsd, Ywsd, Ywsd, Ywsd, Ywsd, Ywsd, Ywsd, Ywsd, Aa, Aa, Aa, Aa, Aa, Aa, Aa, Aa, Aa, Aa, Spay, Spay, Aa, Aa, Aa, Aa, Aa, Aa, Aa, Aa, Aa, Aa, Aa, Aa, Aa, Aa, Aa, Aa, Aa, Aa, Aa
Ywsd, Ywsd, Ywsd, Ywsd, Ywsd, Ywsd, Ywsd, Ywsd, Ywsd, Ywsd, Ywsd, Ywsd, Ywsd, Ywsd, Ywsd, Ywsd, Ywsd, Aa, Aa, Aa, Aa, Aa, Aa, Aa, Aa, Aa, Re^Vct, Spay, Spay, Aa, Aa, Aa, Aa, Aa, Aa, Dyb, Dyb, Aa, Aa, Aa, Aa, Aa, Aa, Aa, Aa, Aa
Ywsd, Ywsd, Ywsd, Ywsd, Ywsd, Ywsd, Ywsd, Ywsd, Aa, Ywsd, Aa, Ywsd, Aa, Ywsd, Aa, Ywsd, Aa, Aa, Aa, Aa, Aa, Aa, Aa, Aa, Aa, Aa, Aa, Re, Ce, Re, Re, Re^Vct, Spay, Aa, Aa, Aa, Aa, Dyb, Aa, Aa, Aa, Aa, Aa, Aa, Aa, Aa
Ywsd, Ywsd, Ywsd, Ywsd, Aa, Ywsd, Aa, Aa, Aa, Aa, Aa, Aa, Ha, Aa, Ha, Aa, Ha, Aa, Aa, Aa, Ha, Aa, Ha, Aa, Aa, Aa, Ce, Ce, 1 Ke, Ce, Ce, Spay, Spay, Aa, Aa, Aa, Aa, Dyb, Aa, Aa, Ha, Ha, Ha, Aa, Ha, Ha
Ywsd, Ywsd, Aa, Aa, Aa, Aa, Ha, Ha, Ha, Ha, Ha, Ha, Ha, Ha, Ha, Ha, Ha, Ha, Ha, Aa, Aa, Ha, Aa, Ha, Aa, Aa, Aa, Ce, Aa, Ce, Re, Spay, Spay, Aa, Aa, Aa, Aa, Aa, Ha, Ha, Ha, Ha, Ha, Ha, Ha, Ha
