border_size=1
usage=map

Ha          , Ha          , Ha          , Ms          , Ms          , Ms          , Ms^Xm       , Ms^Xm       , Ms^Xm       , Ms          , Ms          , Aa          , Ms          , Aa          , Aa          , Aa          , Aa          , Aa          , Aa          , Aa          , Aa          , Aa          
Ha          , Ha          , Ms          , Ms          , Ms          , Ms          , Ms^Xm       , Ms^Xm       , Ms^Xm       , Ms^Xm       , Ms^Xm       , Ms          , Ms          , Ms          , Aa          , Aa          , Aa          , Aa          , Aa          , Aa          , Aa          , Aa          
Ha          , Ha          , Ha          , Ha          , Ms          , Ms          , Ms^Xm       , Ms^Xm       , Xyui        , Xyui        , Xyui        , Ms^Xm       , Ms          , Ms          , Aa          , Aa          , Aa          , Aa          , Aa          , Aa          , Aa          , Aa          
Ha          , Ha          , Ha          , Ha          , Ha          , Ms          , Ms^Xm       , Ms^Xm       , Xyui        , Qxyi        , Xyui        , Ms^Xm       , Ms^Xm       , Ms          , Ms          , Aa          , Aa          , Aa          , Aa          , Aa          , Aa          , Aa          
Aa          , Ha          , Ha          , Ha          , Ha          , Ms          , Ms^Xm       , Ms^Xm       , Xyui        , Uyi         , Xyui        , Ms^Xm       , Ms^Xm       , Ms          , Ms          , Aa          , Ha          , Aa          , Ha          , Aa          , Ai          , Aa          
Aa          , Aa          , Ha          , Ha          , Ha          , Ms          , Ms^Xm       , Ms^Xm       , Xyui        , Uyi         , Xyui        , Ms^Xm       , Ms^Xm       , Ms          , Ms          , Ha          , Ha          , Ms          , Ms          , Ha          , Ai          , Ai          
Aa          , Aa          , Aa          , Ha          , Ha          , Ms          , Ms^Xm       , Xyui        , Uyi         , Uyi         , Uyi         , Xyui        , Xyui        , Ms^Xm       , Ms          , Ha          , Ha          , Ms          , Ha          , Ha          , Ai          , Ai          
Aa          , Aa          , Aa          , Aa          , Ha          , Ms          , Ms          , Aa          , Aa          , Uyi         , Aa          , Uyi         , Xyui        , Ms^Xm       , Ms          , Aa          , Aa          , Ha          , Aa          , Ai          , Ai          , Ai          
Ha          , Ha          , Aa          , Aa          , Ha^Fpa      , Ha          , Aa          , Aa          , Aa          , Aa          , Rb          , Aa          , Aa          , Ms          , Aa          , Aa          , Aa          , Aa          , Aa          , Aa          , Aa          , Aa          
Aa          , Ha          , Aa          , Aa          , Aa^Fpa      , Ha^Fpa      , Aa^Fpa      , Aa^Fpa      , Aa^Fpa      , Aa          , Rb          , Aa^Fpa      , Aa^Fpa      , Ha^Fpa      , Aa          , Aa          , Aa          , Aa          , Aa          , Aa          , Aa          , Aa          
Aa          , Aa          , Aa          , Aa          , Aa          , Aa^Fpa      , Aa          , Aa^Fpa      , Aa          , Aa          , Rb          , Aa          , Aa^Fpa      , Aa^Fpa      , Rb          , Aa          , Aa          , Aa          , Aa          , Aa          , Aa          , Aa          
Aa          , Aa          , Aa          , Aa          , Aa          , Aa          , Rb          , Aa          , Rb          , Rb          , Aa          , Aa          , Rb          , Rb          , Aa          , Aa^Fpa      , Aa^Fpa      , Aa          , Aa          , Aa          , Aa          , Aa          
Aa          , Aa          , Aa^Fpa      , Rb          , Aa          , Rb          , Aa          , Aa          , Aa          , Rb          , Aa          , Aa          , Aa          , Rb          , Aa          , Aa^Fpa      , Aa          , Aa^Fpa      , Aa^Fpa      , Aa          , Aa          , Aa          
Aa          , Aa          , Aa          , Rb          , Aa          , Aa          , Aa^Fpa      , Aa^Fpa      , Aa^Fpa      , Aa          , Aa          , Aa          , Ha^Fpa      , Aa^Fpa      , Aa          , Rb          , Aa          , Aa^Fpa      , Aa          , Aa          , Aa          , Aa          
Ha          , Aa          , Aa          , Rb          , Aa          , Aa          , Aa          , Aa^Fpa      , Aa^Fpa      , Aa^Fpa      , Aa          , Aa^Fpa      , Aa^Fpa      , Aa^Fpa      , Aa          , Rb          , Aa          , Aa          , Aa          , Aa          , Aa          , Aa          
Ha          , Aa          , Aa          , Rb          , Rb          , Aa          , Aa          , Aa          , Aa          , Aa          , Aa          , Aa^Fpa      , Aa^Voa      , Aa^Fpa      , Aa          , Rb          , Aa          , Aa          , Aa          , Aa          , Aa          , Aa          
Ha          , Aa          , Aa          , Aa^Fpa      , Aa^Fpa      , Rb          , Rb          , Rb          , Rb          , Aa          , Aa          , Aa          , Aa          , Aa          , Rb          , Aa          , Aa          , Aa          , Aa          , Aa          , Aa          , Aa          
Aa          , Aa          , Aa          , Aa^Fpa      , Aa          , Aa          , Aa          , Rb          , Rb          , Aa^Fpa      , Rb          , Aa          , Rb          , Rb          , Aa          , Aa          , Ha          , Aa          , Aa          , Aa          , Ai          , Ai          
Aa          , Aa          , Aa          , Aa          , Aa          , Aa          , Ha          , Aa          , Aa          , Rb          , Aa          , Aa          , Aa          , Aa          , Aa          , Aa          , Aa          , Aa          , Ai          , Ai          , Ai          , Ai          
Aa          , Aa          , Ha          , Ha          , Ha          , Ha          , Ms          , Ms          , Xyui        , Aa          , Xyui        , Ms          , Ms          , Ha          , Ha          , Ha          , Aa          , Aa^Fpa      , Ai          , Ai          , Ai          , Ai          
Aa          , Aa          , Aa          , Ha          , Ms          , Ms^Xm       , Ms          , Ms^Xm       , Xyui        , Uyi         , Xyui        , Ms^Xm       , Ms^Xm       , Ms          , Ms          , Ha          , Ha          , Aa          , Ai          , Ai          , Ai          , Ai          
Aa          , Aa          , Aa          , Aa          , Ha          , Ms          , Ms^Xm       , Ms^Xm       , Xyui        , Uyi         , Xyui        , Ms^Xm       , Ms^Xm       , Ms          , Ms          , Ha          , Ha          , Aa          , Aa          , Ai          , Ai          , Ai          
Aa          , Aa          , Aa          , Ha          , Ha          , Ms          , Ms^Xm       , Xyui        , Uyi         , Uyi         , Uyi         , Xyui        , Ms^Xm       , Ms^Xm       , Ms          , Ha          , Aa          , Aa          , Aa          , Aa^Fpa      , Ai          , Ai          
Ha          , Ha          , Ha          , Ha          , Ha          , Ms          , Ms^Xm       , Xyui        , Aa          , Aa          , Aa          , Xyui        , Ms^Xm       , Ms^Xm       , Ha^Fpa      , Ha          , Aa^Fpa      , Aa^Fpa      , Aa          , Aa          , Aa          , Aa          
Ha          , Ha          , Ha          , Ha          , Ha          , Ha          , Aa          , Aa          , Aa          , Rb          , Aa          , Aa          , Aa          , Ha^Fpa      , Ha^Fpa      , Ha^Fpa      , Aa^Fpa      , Aa          , Aa          , Aa          , Ai          , Aa          
Ha          , Ha          , Ha          , Ha          , Aa          , Aa          , Aa          , Aa^Fpa      , Rb          , Rb          , Aa^Fpa      , Aa          , Aa          , Aa^Fpa      , Aa^Fpa      , Ha^Fpa      , Aa^Fpa      , Aa          , Aa          , Aa          , Ai          , Ai          
Ha          , Ha          , Ha          , Ha          , Aa          , Aa          , Aa          , Rb          , Aa          , Aa          , Aa          , Aa          , Aa          , Aa^Fpa      , Aa^Fpa      , Aa^Fpa      , Aa^Fpa      , Aa          , Aa          , Aa          , Ai          , Ai          
Ha          , Ha          , Ha^Fpa      , Ha^Fpa      , Aa          , Aa          , Aa          , Rb          , Aa^Fpa      , Aa          , Aa^Fpa      , Aa          , Aa          , Aa          , Aa^Fpa      , Aa^Fpa      , Aa^Fpa      , Aa          , Aa          , Aa          , Aa          , Ai          
Ha          , Ha^Fpa      , Aa^Fpa      , Aa^Fpa      , Aa          , Aa          , Rb          , Rb          , Aa          , Aa^Fpa      , Aa^Fpa      , Aa          , Aa          , Aa          , Aa          , Aa^Fpa      , Aa          , Aa          , Aa^Fpa      , Aa          , Aa          , Aa          
Ha          , Ha^Fpa      , Aa^Fpa      , Aa^Fpa      , Aa^Fpa      , Aa^Voa      , Rb          , Aa          , Aa          , Aa          , Aa          , Aa          , Aa          , Aa          , Aa          , Aa          , Rb          , Rb          , Rb          , Aa          , Aa          , Aa          
Aa          , Ha^Fpa      , Aa          , Aa          , Aa^Fpa      , Aa^Fpa      , Ai          , Rb          , Aa          , Aa          , Aa          , Aa          , Aa          , Aa          , Rb          , Rb          , Aa          , Aa          , Aa          , Aa          , Aa          , Aa          
Aa          , Aa          , Aa          , Aa          , Aa          , Aa          , Ai          , Aa          , Rb          , Aa^Fpa      , Rb          , Aa^Fpa      , Aa          , Aa          , Aa          , Aa          , Ha          , Ha          , Ha          , Aa          , Ha          , Aa          
Aa          , Aa          , Ai          , Aa          , Ai          , Ai          , Ai          , Aa          , Aa          , Rb          , Rb          , Rb          , Rb          , Aa^Fpa      , Aa          , Ha^Fpa      , Ha^Fpa      , Ha          , Ha          , Ha          , Ha          , Aa          
Ai          , Ai          , Ai          , Ai          , Ai          , Ai          , Ai          , Ai          , Ai          , Aa          , Aa^Fpa      , Rb          , Aa          , Aa          , Aa          , Ha^Fpa      , Ha^Fpa      , Ha          , Ha          , Ha          , Aa          , Aa          
Ai          , Ai          , Ai          , Ai          , Ai          , Ai          , Aa^Fpa      , Ai          , Ai          , Ai          , Ai          , Aa^Fpa      , Aa          , Rb          , Rb          , Aa^Fpa      , Ha^Fpa      , Ha^Fpa      , Aa          , Aa          , Aa          , Aa          
Aa          , Ai          , Ai          , Ai          , Aa^Fpa      , Aa^Fpa      , Aa^Fpa      , Aa          , Aa          , Aa          , Aa          , Aa          , Aa          , Rb          , Rb          , Aa^Voa      , Aa^Fpa      , Ha^Fpa      , Aa          , Aa          , Aa          , Aa          
Aa          , Aa          , Aa          , Aa          , Aa          , Aa^Fpa      , Aa          , Aa^Fpa      , Aa          , Aa          , Aa^Fpa      , Aa^Fpa      , Aa          , Aa          , Rb          , Rb          , Aa^Fpa      , Aa^Fpa      , Aa          , Aa          , Aa          , Aa          
Aa          , Aa          , Aa          , Aa          , Aa          , Aa          , Aa          , Aa          , Aa          , Aa          , Aa          , Aa          , Aa          , Aa          , Aa          , Aa^Fpa      , Aa          , Aa          , Aa          , Aa          , Aa          , Aa          
Aa          , Aa          , Aa          , Aa          , Aa          , Aa^Fpa      , Aa^Fpa      , Aa^Fpa      , Aa^Fpa      , Aa          , Rb          , Rb          , Aa          , Aa^Fpa      , Aa          , Aa          , Aa          , Aa          , Aa          , Aa          , Aa          , Aa          
Aa          , Aa          , Aa          , Aa          , Aa          , Aa          , Aa          , Rb          , Rb          , Rb          , Aa^Fpa      , Aa          , Aa          , Aa          , Aa          , Aa          , Aa          , Aa          , Aa          , Aa          , Aa          , Aa          
Aa          , Aa          , Aa          , Aa          , Aa          , Aa          , Aa          , Aa^Voa      , Aa^Fpa      , Aa^Fpa      , Aa^Fpa      , Aa          , Aa          , Aa          , Aa          , Aa          , Aa          , Aa          , Aa          , Aa          , Aa          , Aa          
Aa          , Aa          , Aa          , Aa^Fpa      , Rb          , Aa          , Aa^Fpa      , Aa          , Aa          , Aa^Fpa      , Aa^Fpa      , Aa          , Aa          , Aa          , Aa          , Aa          , Aa          , Aa          , Aa          , Aa          , Aa^Fpa      , Aa^Fpa      
Aa          , Aa          , Aa^Fpa      , Rb          , Rb          , Rb          , Rb          , Aa          , Aa          , Aa          , Aa          , Aa          , Aa          , Aa          , Aa          , Aa          , Aa          , Aa          , Aa          , Aa          , Aa^Fpa      , Aa^Fpa      
Aa          , Aa          , Ha^Fpa      , Aa^Fpa      , Aa^Fpa      , Rb          , Rb          , Rb          , Aa          , Aa          , Aa^Fpa      , Aa^Fpa      , Aa          , Aa          , Aa          , Aa          , Aa^Fpa      , Aa          , Aa          , Aa          , Aa          , Aa^Fpa      
Aa          , Ha          , Ha          , Ha^Fpa      , Aa          , Aa          , Aa          , Rb          , Aa^Fpa      , Aa^Fpa      , Aa^Fpa      , Aa^Fpa      , Aa          , Aa          , Aa          , Aa          , Aa          , Aa          , Aa          , Aa          , Aa          , Aa          
Aa          , Ha          , Aa          , Aa          , Aa          , Aa          , Aa          , Aa          , Aa^Fpa      , Aa^Fpa      , Rb          , Aa          , Aa          , Aa          , Aa          , Aa          , Aa          , Aa          , Aa          , Aa          , Aa^Fpa      , Aa          
Aa          , Aa          , Aa          , Aa          , Aa^Fpa      , Aa          , Aa          , Aa          , Aa          , Aa          , Rb          , Aa          , Aa          , Aa          , Aa          , Aa          , Aa          , Aa          , Aa          , Aa          , Aa^Fpa      , Aa^Fpa      
Aa          , Aa          , Aa          , Aa          , Aa          , Aa          , Aa          , Aa          , Aa          , Aa          , Aa          , Rb          , Rb          , Aa          , Aa^Fpa      , Aa          , Aa          , Aa          , Aa          , Aa          , Aa          , Aa^Fpa      
Aa          , Aa          , Aa          , Aa          , Aa          , Aa          , Aa          , Aa          , Aa          , Aa^Fpa      , Aa^Fpa      , Aa^Fpa      , Aa          , Rb          , Rb          , Rb          , Aa          , Aa          , Aa          , Aa          , Aa          , Aa          
Aa          , Aa          , Aa          , Aa          , Aa          , Aa          , Aa          , Aa^Fpa      , Aa^Fpa      , Aa^Fpa      , Aa^Fpa      , Aa^Fpa      , Aa^Voa      , Aa          , Aa          , Aa^Fpa      , Aa          , Aa          , Aa          , Aa          , Aa          , Aa          
Aa          , Aa          , Aa          , Aa          , Aa          , Aa          , Aa          , Aa^Fpa      , Aa          , Aa^Fpa      , Aa          , Aa          , Aa          , Aa          , Aa          , Aa          , Rb          , Aa          , Aa          , Aa          , Aa^Fpa      , Aa          
Aa          , Aa          , Aa          , Aa          , Aa          , Aa          , Aa          , Aa          , Aa          , Aa          , Aa          , Aa          , Rb          , Aa          , Aa          , Aa          , Rb          , Aa^Fpa      , Aa          , Aa          , Aa^Fpa      , Aa          
Aa          , Aa          , Aa          , Aa          , Aa          , Aa          , Aa          , Aa          , Aa          , Aa          , Aa^Fpa      , Rb          , Rb          , Rb          , Rb          , Rb          , Aa^Fpa      , Aa^Fpa      , Aa          , Aa          , Aa          , Aa^Fpa      
Aa          , Aa          , Ha          , Aa          , Aa          , Aa          , Aa          , Aa          , Rb          , Aa          , Aa          , Rb          , Aa          , Rb          , Aa          , Aa^Fpa      , Aa          , Aa^Fpa      , Aa          , Aa          , Aa          , Aa          
Aa          , Ha          , Ha          , Ha          , Aa          , Aa          , Aa          , Aa          , Rb          , Aa          , Aa          , Aa          , Aa          , Aa          , Aa          , Aa          , Aa          , Aa          , Aa          , Aa          , Aa          , Aa          
Ha^Fpa      , Ha^Fpa      , Aa          , Aa          , Aa          , Aa          , Aa          , Aa          , Aa^Fpa      , Rb          , Aa          , Aa          , Aa          , Aa          , Aa          , Aa          , Aa          , Aa          , Aa          , Aa          , Aa          , Aa          
Ha^Fpa      , Ha^Fpa      , Aa          , Aa          , Aa          , Aa          , Aa          , Aa          , Aa^Fpa      , Rb          , 1 Rb        , Aa          , Aa^Fpa      , Aa          , Aa          , Aa          , Aa          , Aa          , Aa          , Aa          , Aa          , Aa          
Aa^Fpa      , Ha^Fpa      , Aa          , Aa          , Aa          , Aa          , Aa          , Aa          , Rb          , Rb          , Rb          , Aa^Fpa      , Aa^Fpa      , Aa          , Aa          , Aa          , Aa          , Aa          , Aa          , Aa          , Aa          , Aa          
Aa^Fpa      , Aa^Fpa      , Aa^Fpa      , Aa^Fpa      , Aa          , Aa          , Aa          , Aa          , Aa          , Rb          , Rb          , Aa^Fpa      , Aa          , Aa          , Aa          , Aa          , Aa          , Aa          , Aa          , Aa          , Aa          , Aa          
Aa^Fpa      , Aa^Fpa      , Aa^Fpa      , Aa          , Aa          , Aa          , Aa          , Aa          , Aa          , Aa          , Rb          , Aa          , Aa          , Aa          , Aa          , Aa          , Aa          , Aa          , Aa          , Aa          , Aa          , Aa          
Aa^Fpa      , Aa^Fpa      , Ha^Fpa      , Ha^Fpa      , Aa          , Aa          , Ha          , Aa          , Aa          , Aa          , Rb          , Aa          , Aa          , Aa          , Aa          , Aa          , Aa^Fpa      , Aa^Fpa      , Aa^Fpa      , Aa          , Aa          , Aa          
Aa^Fpa      , Aa^Fpa      , Ha^Fpa      , Ha^Fpa      , Ha          , Ha          , Ha          , Aa          , Aa          , Aa          , Aa          , Rb          , Aa          , Aa          , Aa          , Aa^Fpa      , Aa^Fpa      , Aa^Fpa      , Aa^Fpa      , Aa          , Aa          , Aa          
