Zdyd, Zdyd, Zdyd, Zdyd, Zdyd, Zdyd, Zdyd, Zdyd, Zdyd, Zdyd, Zdyd, Zdyd, Zdyd, Zdyd, Zdyd, Zdyd, Zdyd, Zdyd, Zdyd, Zdyd, Zdyd, Zdyd, Zdyd, Zdyd, Zdyd, Zdyd, Zdyd, Zdyd, Zdyd, Zdyd, Zdyd, Zdyd, Zdyd, Zdyd, Zdyd, Zdyd, Zdyd, Zdyd, Zdyd, Zdyd, Zdyd, Zdyd
Zdyd, Zdyd, Zdyd, Zdyd, Zdyd, Zdyd, Zdyd, Zdyd, Zdyd, Zdyd, Zdyd, Zdyd, Zdyd, Zdyd, Zdyd, Zdyd, Zdyd, Zdyd, Zdyd, Zdyd, Ms^Xm, Zdyd, Zdyd, Zdyd, Zdyd, Zdyd, Zdyd, Zdyd, Zdyd, Zdyd, Zdyd, Zdyd, Zdyd, Zdyd, Zdyd, Zdyd, Zdyd, Zdyd, Zdyd, Zdyd, Zdyd, Zdyd
Zdyd, Zdyd, Zdyd, Zdyd, Zdyd, Zdyd, Zdyd, Zdyd, Zdyd, Zdyd, Zdyd, Zdyd, Zdyd, Zdyd, Zdyd, Zdyd, Zdyd, Zdyd, Ms^Xm, Ms^Xm, Ms, Ms^Xm, Ms^Xm, Ms^Xm, Ms^Xm, Zdyd, Ms, Zdyd, Ms, Zdyd, Ms, Zdyd, Zdyd, Zdyd, Zdyd, Zdyd, Zdyd, Zdyd, Zdyd, Zdyd, Zdyd, Zdyd
Zdyd, Zdyd, Zdyd, Zdyd, Zdyd, Zdyd, Zdyd, Zdyd, Zdyd, Zdyd, Zdyd, Zdyd, Zdyd, Zdyd, Zdyd, Zdyd, Ms, Ms, Cay, Ms, Cay^Yt/p, Cay, Cay, Ms^Xm, Cay, Ms^Xm, Cay, Cay, Cay^Yt\p, Cay, Cay, Cay, Cay, Zdyd, Zdyd, Zdyd, Zdyd, Zdyd, Zdyd, Zdyd, Zdyd, Zdyd
Zdyd, Zdyd, Zdyd, Zdyd, Zdyd, Zdyd, Zdyd, Zdyd, Zdyd, Zdyd, Zdyd, Zdyd, Zdyd, Zdyd, Ms, Ms, Cay, Cay, Cay^Ytwt, Cay, Cay, Cay, Cay^Esa, Cay, Cay, Cay, Cay, Cay, Cay, Cay, Cay, Cay^Ytot, Cay, Cay, Cay, Zdyd, Zdyd, Zdyd, Zdyd, Zdyd, Zdyd, Zdyd
Zdyd, Zdyd, Zdyd, Zdyd, Zdyd, Zdyd, Zdyd, Zdyd, Zdyd, Zdyd, Ms^Xm, Ms, Cay^Esa, Ms^Xm, Cay, Cay, Cay, Cay, Cay, Cay^Es, Cay, Cay, Cay, Cay, Isa, Isa, Rr, Cay, Rp, Cay, Rp, Cay, Cay, Cay, Cay, Ms, Ms, Zdyd, Zdyd, Zdyd, Zdyd, Zdyd
Zdyd, Zdyd, Zdyd, Zdyd, Ms, Zdyd, Zdyd, Zdyd, Ms^Xm, Ms, Cay, Cay, Cay, Cay, Cay, Cay, Cay, Cay, Isa, Cay, Rr, Isa, Isa, Isa, Isa, Isa, Rrc^Dr, Rr, Rr, Rp, Isa, Rp, Isa, Cay, Cay, Cay, Cay, Ms, Ms, Zdyd, Zdyd, Zdyd
Ms, Zdyd, Ms, Ms, Ha, Ms, Ms^Xm, Ms^Xm, Ms, Ms, Cay, Cay, Isa, Cay, Isa, Rr, Rr, Isa, Isa, Rr, Cay, Cay, Cay, Rr, Rrc, Rrc, Rrc, Rrc^Es, Rrc, Isa, Isa, Isa, Isa, Isa, Cay, Cay, Cay, Ha, Ms, Ms, Zdyd, Zdyd
Ms, Ms, Ha, Ha, Ha, Ha, Ms^Xm, Ms^Xm, Ms, Cay, Cay, Cay, Isa, Isa^Es, Isa, Rrc^Es, Rr^Es, Isa^Dr, Isa, Isa, Cay, Cay^Yalt, Cay, Isa, Isa, Rrc^Esa, Isa, Isa, Isa, Rr, Rp, Isa, Isa, Rp, Cay, Cay^Yt/p, Cay, Ha, Ha, Ms, Ms, Zdyd
Ms, Ms, Ms, Ha, Ha, Ha^Fpa, Ha^Fpa, Ms^Xm, Ms, Cay, Cay^Dr, Cay, Cay, Isa, Rr, Rr, Rr, Rr, Ymnt, Isa, Rp, Cay, Rr, Isa, Isa^Ecf, Isa, Cay, Isa, Rr, Rp^Es, Rp^Dr, Isa^Es, Isa, Isa, Cay, Cay, Cay, Ha, Ha, Ms, Ms, Ms
Ms, Ms, Ms, Ha, Ha, Ha^Fpa, Ha^Fpa, Ha^Fpa, Ha^Fpa, Cay, Cay, Cay^Es, Cay, Cay, Cay, Cay, Cay, Rr, Cay, Rr, Rrc, Rr, Isa, Isa, Isa, Cay, 2 Kay, Cay, Re^Vct, Rr, Isa, Isa^Es, Isa, Isa, Cay, Cay, Cay, Ha, Ha, Ha, Ms, Ms
Ms, Ms, Ms, Ms, Ms, Ha, Ha^Fpa, Ha^Fpa, Ha^Fpa, Ha^Qov, Ha^Qov, Cay, Cay, Cay, Cay, Cay^Es, Cay, Cay, Cay^Yt\p, Cay, Cay, Cay, Cay, Cay, Isa, Cay, Cay, Cay, Isa, Isa, Isa, Isa, Cay, Cay, Cay^Es, Cay^Es, Cay, Ha^Qov, Ha, Ha, Ms, Ms
Ms, Ha, Ms, Ms, Ms, Ha^Fpa, Ha, Ha^Fpa, Ha, Ha, Ha^Fpa, Ha^Qov, Ha^Qov, Ha^Qov, Ha^Qov, Cay, Ha^Qov, Cay, Cay, Cay, Cay, Cay^Ytot, Cay, Cay^Ebn, Isa, Isa, Isa, Isa, Isa, Rr, Cay, Cay, Cay^Es, Cay^Dr, Cay, Cay, Ha^Qov, Ha^Qov, Ha, Ha, Ms, Ha
Ms, Ha, Ha, Ms, Ms, Ha, Ha, Ha, Ha^Fpa, Ha, Ha, Ha, Ha, Ha, Ha, Ha^Qov, Ha, Ha^Qov, Ha^Qov, Cay, Ha^Qov, Cay, Isa, Isa, Isa, Isa, Cay, Cay, Cay, Cay, Cay, Cay^Esa, Cay, Cay, Cay, Cay, Ha^Qov, Ha, Ms, Ms, Ms, Ms
Ms, Ha, Ha, Ms, Ms, Ha, Ha, Ha, Ha, Ha, Ha, Ha, Ha^Fpa, Ha, Ha, Ms, Ms, Ha, Ha, Ha^Qov, Ha, Ha, Rrc, Isa, Isa, Isa^Ebn, Cay, Cay^Ytwt, Cay^Esa, Cay^Yt/p, Cay, Cay, Ha^Qov, Ha^Qov, Ha^Qov, Ha^Qov, Ha, Ms, Ms, Ms, Ms, Ms
Mm^Xm, Ha, Ha, Ha, Rb, Ha, Aa^Fpa, Ha, Ha, Ha, Ha, Ha, Aa^Fpa, Ha, Ha, Ms, Ms, Ms, Ms, Ha, Ha, Rra, Rra, Isa, Rrc, Ha, Ha^Qov, Cay, Cay, Cay, Ha^Qov, Ha^Qov, Ha, Ha, Ha, Ha, Ms, Ms, Ms, Ms, Ms^Xm, Ms^Xm
Mm^Qhh, Mm^Xm, Rb, Rb, Aa^Fpa, Aa^Fpa, Aa^Fpa, Aa^Fpa, Ms^Xm, Ms^Xm, Ms^Xm, Aa^Fpa, Aa^Fpa, Aa^Fpa, Aa^Fpa, Ha, Ha, Ms, Ha, Ha, Aa^Fpa, Aa^Fpa, Isa, Rr, Re^Vct, Ha, Ha, Ha^Qov, Ha^Qov, Ha^Qov, Ha, Ha, Ha, Ha, Ha^Fpa, Ms, Ms, Ms, Ms, Ms^Xm, Ms^Xm, Ms^Xm
Rb^Qhh, Rb, Rb, Ha, Aa^Fpa, Aa^Fpa, Aa^Fpa, Ms^Xm, Ms^Xm, Ms^Xm, Ms^Xm, Aa^Fpa, Aa^Fpa, Aa^Feta, Aa^Fpa, Aa^Fpa, Aa^Fpa, Ha, Ha^Fpa, Aa^Fpa, Aa^Fpa, Aa^Fpa, Rr, Rp, Aa^Fpa, Ha, Ha, Ha, Aa^Fpa, Aa^Fpa, Ha^Fpa, Aa^Fpa, Ha^Fpa, Ha^Fpa, Ha^Fpa, Ha^Fpa, Ha^Fpa, Ms, Ms, Ms, Ms, Ms
Rb^Qhh, Rb, Rb, Ha, Ha, Aa^Fpa, Aa^Fpa, Ms^Xm, Aa^Fpa, Ms^Xm, Ms, Ms, Aa^Fpa, Aa^Fpa, Aa^Fpa, Aa^Fpa, Aa^Fpa, Ha, Ha, Aa^Fpa, Rb, Aa^Fpa, Rr, Rp, Rb, Aa^Fpa, Ha^Fpa, Aa^Fpa, Ha^Fpa, Ha^Fpa, Ha^Fpa, Ha^Fpa, Ha^Fpa, Ha^Fpa, Ha^Fpa, Ha^Fpa, Ha^Fpa, Ha^Fpa, Ms, Ms, Ms, Ms
Ms^Qhh, Ha, Ha, Rb, Ha, Ha^Fpa, Ha^Fpa, Aa^Fpa, Aa^Fpa, Ms, Ms, Ms, Aa^Fpa, Ha, Rb^_mh, Aa^Fpa, Rb, Ha^Vhha, Rb, Rb, Rp, Rb, Rb, Rb, Rb, Aa^Fpa, Ha, Aa^Fpa, Ha^Fpa, Ha^Fpa, Ha^Fpa, Ha^Fpa, Ha^Fpa, Ha^Fpa, Aa^Fpa, Ha^Fpa, Ms, Ms, Ms, Ms, Ms, Ms
Ms^Qhh, Ms^Xm, Ms, Ha, Ha, Ha, Ha, Ha, Aa, Aa^Fpa, Aa^Fpa, Aa^Fpa, Rb, Rb, Re, Re, Re, Re, Isa, Rp, Rp, Rp, Re, Re, Re^Es, Re^Es, Re^Es, Ha, Ha, Ha, Ms, Ms, Ms, Ha^Fpa, Ms, Ms, Ms, Ms, Ms, Ms, Ms, Ms
Ms^Qhh, Ms, Ms, Ms, Ha, Ha, Aa, Aa, Rb, Rb, Rb, Rb, Re, Re^Es, Re, Rd, Re, Isa, Rp, Rp^Es, Rp, Rra, Cea, Re, Re, Rd^Dr, Re^Es, Ai, Ha, Ms, Ms, Ms, Ms^Xm, Ms, Ms^Xm, Ms^Xm, Ms^Xm, Ms, Ms, Ms, Ha, Ms
Ms^Qhh, Ms, Ms, Ms, Ha, Aa, Rb, Rb^Es, Rb, Rb, Rb, Re, Aa, Re, Ha, Re, Ha, Rb, Ha, Rb, Re^Vct, Cea, Cea^Esa, Cea, Aa^Fpa, Re^Es, Rb, Aa, Ha, Ms, Ms, Ms, Ms^Xm, Ms^Xm, Ms^Xm, Ms^Xm, Ms^Xm, Ms, Ha, Ha, Ha, Ha
Ms^Qhh, Ms^Xm, Ms, Ms, Aa^Fpa, Aa, Rb, Rb, Rb^Esa, Rb, Aa^Fpa, Aa^Fpa, Ha, Aa^Fpa, Ha^Fpa, Ha, Ha, Ha, Ha, Ha, Ha, Cea, Cea, Cea^Esa, Aa^Fpa, Isa, Isa, Rb, Ai, Ms, Ms, Ms^Xm, Ms^Xm, Ms^Xm, Ms^Xm, Ms^Xm, Ms, Ha, Ha^Fpa, Ha, Ha, Ha^Qhhf
Ms^Qhh, Ms^Qhh, Ms^Qhh, Ms, Aa^Qhhf, Re, Re^Es, Isa, Ai, Ai, Aa^Fpa, Aa^Fpa, Aa^Fpa, Aa^Fpa, Ha^Fpa, Ha, Ha, Ha, Ms, Ha^Fpa, Ha^Fpa, Ha^Fpa, Ha, Ha, Rb, Isa, Isa, Rb, Ha, Ms, Ms, Ms^Xm, Ms^Xm, Ms^Xm, Ms^Xm, Ms, Ms, Ha^Fpa, Ha^Fpa, Ha^Fpa, Ha^Fpa, Ha^Qhhf
Ms^Xm, Ms^Xm, Ms, Ms^Qhh, Ms, Re^Qhh, Isa^Qhh, Rb^Qhh, Aa^Qhh, Ai^Esa, Aa^Fpa, Aa^Fpa, Ha^Fpa, Ha^Fpa, Ha^Fpa, Ha^Fpa, Ms^Xm, Ms, Ms, Ms, Ms, Ha, Ha, Aa^Fpa, Rb, Rb^Es, Rb, Ai, Ms, Ms, Ms, Ms^Xm, Ms^Qhh, Ms^Xm, Ms, Ms, Ha, Ha^Fpa, Ha^Fpa, Ha^Fpa, Aa^Fpa, Aa^Qhhf
Ms^Xm, Ms, Aa^Fpa, Ms, Ha, Aa, Isa^Es, Isa, Rb, Ha^Qhh, Ha^Qhh, Aa^Fpa, Ha^Fpa, Ha^Fpa, Ms^Xm, Ms^Xm, Ms^Xm, Ms, Ms, Ms, Ms, Ha, Rb^Qhh, Isa^Qhh, Isa^Qhh, Rb^Qhh, Ms^Qhh, Ms^Qhh, Ms^Qhh, Ms^Qhh, Ms^Qhh, Ms^Qhh, Ms, Ms^Qhh, Ms^Qhh, Ms^Qhh, Ms^Qhh, Ha, Ha^Fpa, Ha^Fpa, Aa^Qhhf, Aa^Qhhf
Ms^Fpa, Aa^Fpa, Aa^Fpa, Aa^Fpa, Aa^Fpa, Aa, Rb, Isa, Isa, Re, Ha, Ha^Qhh, Ha^Qhh, Ha^Fpa, Ms, Ms^Xm, Ms^Qhh, Ms, Aa^Qhh, Ms^Qhh, Aa^Qhh, Rb^Qhh, Rp, Isa, Re, Aa, Ms, Ms, Ms, Ms, Ms, Ms, Ha, Ms, Ms, Ms, Ms, Ha^Qhh, Ha^Qhhf, Ha^Qhhf, Aa^Fpa, Aa^Fpa
Ms^Fpa, Aa^Fpa, Aa^Fpa, Aa^Fpa, Aa^Fpa, Aa, Aa^Fpa, Rb, Rb, Rb, Rb, Ha, Ha, Ms^Qhh, Ms^Qhh, Ms^Qhh, Ms, Aa^Qhh, Aa, Aa, Rb^Es, Rp, Rb, Rb, Aa^Fpa, Aa^Fpa, Ha^Fpa, Ms, Ha, Ai, Ms, Ha, Ha, Ha, Ha, Ha, Ha, Ha^Fpa, Ha^Fpa, Aa^Fpa, Aa^Fpa, Aa^Fpa
Ms^Fpa, Aa^Fpa, Aa^Fpa, Aa^Fpa, Aa^Fpa, Aa^Fpa, Aa^Fpa, Ha, Rb, Rb^Esa, Rb, Rb, Re, Ms, Ms^Vhha, Ms, Re^Esa, Aa, Rp, Rp, Rb, Rb, Aa, Aa^Fpa, Ha^Fpa, Aa^Fpa, Ha^Fpa, Ha, Ha, Ha, Ha, Ha, Ha^Fpa, Ha^Fpa, Ha^Fpa, Ha^Fpa, Ha^Fpa, Ha^Fpa, Aa^Fpa, Aa^Fpa, Aa^Fpa, Aa^Fpa
Ms^Fpa, Ha, Ha, Aa^Fpa, Aa^Fpa, Aa^Fpa, Aa^Fpa, Aa^Fpa, Ha, Aa, Aa, Rb, Isa, Re, Re, Re, Rb, Rp, Rb, Rb, Aa, Aa^Esa, Ha, Ha, Ha^Fpa, Ha^Fpa, Ha, Ha, Ha, Ha, Ha, Ha, Ha^Fpa, Ha^Fpa, Ha^Fpa, Ha^Fpa, Ha^Fpa, Ha^Fpa, Aa^Fpa, Aa^Fpa, Aa^Fpa, Ha
Ms^Fpa, Ha^Fpa, Ha, Ha, Ha^Fpa, Aa^Fpa, Aa^Fpa, Aa^Fpa, Ha, Ha, Aa, Re, Rb, Rb, Rb^Es, Rb, Rp, Rr, Cay, Re^Vct, Ha, Ha, Ha, Ha^Fpa, Ha^Fpa, Ha, Ha, Ha, Ms^Xm, Ms^Xm, Ms^Xm, Ms^Xm, Ms^Xm, Ms^Xm, Ha^Fpa, Ha^Fpa, Ms^Xm, Aa^Fpa, Aa^Fpa, Aa^Fpa, Ha, Ha
Ms^Xm, Aa^Fpa, Aa^Fpa, Ha, Ha, Ha, Ha, Ha, Ha^Fpa, Ha, Ha, Ha, Ha, Rb, Rb, Rb, Rp, Cay, 5 Kay, Cay, Ha, Ha, Ha, Ha^Fpa, Ha, Ha, Ha, Ms^Xm, Ms^Xm, Ms^Xm, Ms^Xm, Ms^Xm, Ms^Xm, Ms^Xm, Ms^Xm, Ms^Xm, Ms^Xm, Ms^Xm, Ha, Ha, Ha^Qhu, Ha^Qhu
Ms^Xm, Aa^Fpa, Aa^Fpa, Ha^Fpa, Ha, Ha, Ms, Ha, Ha, Ha, Ha, Ha, Aa^Fpa, Aa, Rb, Rp, Isa, Cay, Cay, Cay, Ha, Ha, Ha, Ha, Ha, Ha, Ms^Xm, Ms^Xm, Ms^Xm, Ms^Xm, Ms^Xm, Ms^Xm, Ms^Xm, Ms^Xm, Ms^Xm, Ms^Xm, Ms^Xm, Ms^Xm, Ha^Qhu, Ha^Qhu, Ha^Qhu, Ha^Qhu
Ms^Xm, Ms^Xm, Ha, Ha, Ha, Ha, Ha, Ha, Ha, Ha, Ha^Fpa, Aa^Fpa, Aa^Fpa, Aa^Fpa, Aa, Rb, Isa, Isa, Rp, Rra, Ai, Ha, Ha, Ha, Ha, Ha, Ms^Xm, Ms^Xm, Ms^Xm, Ms^Xm, Ms^Xm, Ms^Xm, Ha^Fpa, Ms^Xm, Ms, Ms, Ms, Ms, Ha^Qhu, Ha, Aa^Qhu, Aa^Qhu
Ms^Xm, Ms^Xm, Ms^Xm, Ha, Ha^Fpa, Ha^Fpa, Ha^Fpa, Ha, Ha, Ha, Ha^Fpa, Ha^Fpa, Ha^Fpa, Aa^Fpa, Ha, Rb, Rb, Rb, Rb, Rp, Rb, Ha, Ha, Ha, Ha, Ha, Ha, Ha, Ha, Ha, Ha, Ms, Ha^Fpa, Ms, Ha, Ha, Ha, Ms, Ha^Qhu, Ha, Aa^Qhuf, Aa^Qhuf
Ha^Fpa, Ms^Xm, Ms^Xm, Ms^Xm, Ha^Fpa, Ha^Fpa, Ha^Fpa, Ha^Fpa, Ha, Ha, Ha, Ha, Ha, Ha, Ha, Ha, Ha, Aa, Cay, Rp, Isa, Ai, Ha, Ha, Ha^Esa, Ha, Ha, Ha, Ha^Fpa, Ha, Ha, Ha^Fpa, Ha^Fpa, Ha^Fpa, Ha, Ha, Ha^Qhu, Ms^Qhu, Ha, Aa^Fpa, Aa^Fpa, Aa^Qhuf
Ha^Fpa, Ms^Xm, Ha, Ms^Xm, Ms^Xm, Ha^Fpa, Ha^Fpa, Ha^Fpa, Ha^Fpa, Ha, Ha, Ha, Ha^Fpa, Ha, Ha, Ha, Ha, Ha, Rb, Isa, Isa, Rb, Rb^Qhu, Ha^Qhu, Ha^Qhu, Ha^Qhu, Ha^Qhu, Ha, Ha^Qhuf, Ha^Fpa, Aa^Qhuf, Aa^Fpa, Aa^Fpa, Aa^Fpa, Aa^Fpa, Ha^Qhu, Ha, Ha, Ha, Aa^Fpa, Aa^Fpa, Aa^Qhuf
Ha^Fpa, Ha^Fpa, Ha, Ms, Ms, Ms^Xm, Ms^Xm, Ha^Fpa, Ms, Ha^Fpa, Ha, Ha, Ha^Qhu, Ha^Qhuf, Ha^Qhu, Ha^Qhu, Ha^Qhu, Ha, Re^Qhu, Rb, Isa^Qhu, Rr^Qhu, Rb, Ai, Ai, Ha, Ha, Ha^Qhu, Aa^Fpa, Aa^Qhuf, Aa^Fpa, Aa^Qhuf, Aa^Qhuf, Aa^Qhuf, Aa^Qhu, Ha^Qhu, Ha, Ha, Ha, Aa^Fpa, Aa^Qhu, Aa^Qhu
Aa^Fpa, Ha^Fpa, Ha^Fpa, Ha, Ha, Ms, Ms^Xm, Ms^Xm, Ms^Xm, Ms, Ms, Ha, Ha^Qhuf, Ha^Qhu, Ha, Ha, Ha, Ha^Qhu, Aa, Rb^Qhu, Rb, Rb^Es, Isa, Rb, Rb, Ai, Aa^Fpa, Aa^Fpa, Aa^Fpa, Aa^Fpa, Aa^Fpa, Aa^Fpa, Aa^Fpa, Aa^Fpa, Ha, Ha, Ha, Ha, Ha, Ha, Aa^Fpa, Aa^Qhu
Aa^Fpa, Aa^Fpa, Aa^Fpa, Ha, Ha, Ms, Ms, Ms^Xm, Ms, Ms^Xm, Ms, Ha, Ha^Qhu, Ha, Ha, Ha, Aa^Fpa, Aa, Aa^Fpa, Aa^Fpa, Aa^Fpa, Rb, Rb, Rb, Rb, Rb, Aa^Fpa, Aa^Fpa, Aa^Fpa, Aa^Fpa, Aa^Fpa, Aa^Fpa, Ha, Ha, Ha, Ha, Ha, Ha, Aa^Fpa, Aa^Fpa, Aa^Fpa, Aa^Qhu
Aa^Fpa, Aa^Fpa, Aa^Fpa, Ha, Ha, Ha, Ha, Ms, Ms, Ms, Ha^Qhuf, Ha, Ha^Qhu, Ha, Ha, Ha, Aa^Fpa, Aa^Fpa, Aa^Fpa, Aa^Fpa, Aa^Fpa, Aa^Fpa, Ai, Rb, Rb, Rb, Rb, Aa^Fpa, Ha, Aa^Fpa, Ha, Ha, Ha, Ha, Ha, Ha, Ha, Ha, Aa^Fpa, Aa^Fpa, Aa^Fpa, Aa^Qhu
Aa^Qhuf, Aa^Fpa, Aa^Qhuf, Aa^Fpa, Aa^Fpa, Ha, Ha^Fpa, Ha, Ha^Qhu, Ha^Qhu, Ha^Qhu, Ha^Qhu, Ha, Ha, Ha, Ha^Fpa, Aa^Fpa, Aa^Fpa, Aa^Fpa, Aa^Fpa, Ha^Fpa, Ha^Fpa, Ha, Rb^Esa, Rb, Rb, Rb, Rb, Rb, Ha, Rb, Ha, Ha, Ha, Ha, Ha, Ha, Aa^Fpa, Aa^Fpa, Aa^Fpa, Aa^Fpa, Aa^Qhu
Aa^Qhu, Aa^Qhuf, Aa^Fpa, Aa^Qhuf, Aa^Qhuf, Aa^Qhuf, Aa^Qhu, Ha^Qhu, Aa, Ha^Qhu, Aa^Fpa, Ha^Fpa, Aa^Fpa, Ha, Aa^Fpa, Aa^Fpa, Aa^Fpa, Aa^Fpa, Aa^Fpa, Aa^Fpa, Ha^Fpa, Ha, Ha, Ha, Ha, Rb^Esa, Rb, Rb, Rb, Rb, Rb, Rb, Rb, Rb, Ce, Aa, Aa, Aa^Fpa, Aa^Fpa, Aa^Fpa, Aa^Fpa, Aa^Qhu
Aa^Qhu, Aa^Fpa, Aa^Fpa, Aa^Fpa, Aa^Fpa, Aa^Fpa, Aa, Aa^_ml, Aa, Aa, Aa, Aa^Fpa, Aa^Fpa, Aa, Aa^Fpa, Aa^Fpa, Aa^Fpa, Aa^Fpa, Aa^Fpa, Aa^Fpa, Aa^Fpa, Ha^Fpa, Ai, Ha, Aa, Aa, Rb, Rb, Rb, Rb, Rb, Rb, Rb, Rb, Ce, Ce, Aa, Aa^Fpa, Aa^Fpa, Aa^Fpa, Aa, Aa^Qhu
Aa^Qhu, Aa, Aa, Aa^Fpa, Aa^Fpa, Aa^Fpa, Aa, Aa^Fpa, Aa, 3 Aa, Aa, Aa, Aa, Aa, Aa^Fpa, Aa^Fpa, Aa^Fpa, Aa^Fpa, Aa^Fpa, Aa^Fpa, Aa^Fpa, Aa^Fpa, Aa^Fpa, Aa, Aa, Aa, Ai, Rb, Rb, Rb, Re^Vct, Rb, Ce, Ce, 1 Ke, Ce, Rb, Aa, Aa, Aa, Aa, Aa^Qhu
Aa^Qhu, Aa^Qhu, Aa^Qhu, Aa^Qhu, Aa^Qhu, Aa^Qhu, Aa^Qhu, Aa^Qhu, Aa^Qhu, Aa^Qhu, Aa^Qhu, Aa^Qhu, Aa^Qhu, Aa^Qhu, Aa^Qhu, Aa^Qhu, Aa^Qhu, Aa^Qhu, Aa^Qhu, Aa^Qhu, Aa^Qhu, Aa^Qhu, Aa^Qhu, Aa^Qhu, Aa^Qhu, Aa^Qhu, Aa^Qhu, Aa^Qhu, Aa^Qhu, Aa^Qhu, Aa^Qhu, Aa^Qhu, Aa^Qhu, Rb^Qhu, Rb^Qhu, Rb^Qhu, Rb^Qhu, Aa^Qhu, Aa^Qhu, Aa^Qhu, Aa^Qhu, Aa^Qhu
