border_size=1
usage=map

Ms^Xm, Ms^Xm, Ms^Xm, Ms^Xm, Ms^Xm, Ms^Xm, Ms^Xm, Ms^Xm, Ms^Xm, Ms^Xm, Ms^Xm, Ms^Xm, Ms^Xm, Ms^Xm, Ms^Xm, Ms^Xm, Ms^Xm
Ms^Xm, Ms^Xm, Ms^Xm, Ms^Xm, Xu, Xu, Xu, Xu, Xu, Xu, Xu, Ms^Xm, Xu, Ms^Xm, Ms^Xm, Ms^Xm, Ms^Xm
Ms^Xm, Ms^Xm, Xu, Xu, Uu, Uu, 1 Uu, Uu, Uu, Uu, Uu, Xu, Xu, Xu, Ms^Xm, Ms^Xm, Ms^Xm
Ms^Xm, Ms^Xm, Xu, Uu, Uu, Uu, Uu, Uu, Uu, Uu, Uu, Uu, Uu, Xu, Xu, Ms^Xm, Ms^Xm
Ms, Ms^Xm, Xu, Xu, Xuc, Uu, Uu, Uu, Uu, Uu, Uu, Uu, Uu, Xu, Xu, Ms^Xm, Ms^Xm
Ms, Ms, Xu, Xu, Xuc, Xuc, Uu, Uu, Ur, Uu, Uu, Uu, Xuc, Xuc, Xu, Ms^Xm, Ms
Ms, Ms, Ha^Fpa, Xu, Uu, Co, Co, Ur, Ur, Uu, Co, Uu, Xuc, Xu, Xu, Ms, Ms
Ms, Ms, Ha^Fpa, Aa, Aa, Uu, Uu, Co, Ur, Ur, Uu, Co, Xuc, Xu, Xu, Ha, Ha
Ha^Fpa, Ha, Ha^Fpa, Aa, Aa, Aa, Rb, Uu, Ur^Es, Ur, Rb, Uu, Aa, Xuc, Aa, Ha^Fpa, Ha
Aa, Aa^Fpa, Aa^Fpa, Aa^Fpa, Aa^Fpa, Aa, Aa, Rb, Rb, Rb, Aa, Aa, Aa, Aa, Aa, Ha^Fpa, Ha^Fpa
Aa, Aa, Aa, Aa, Aa, Aa, Aa, Aa, Rb, Aa, Aa, Aa, Aa, Aa, Aa, Ha^Fpa, Aa^Fpa
Aa, Aa, Aa, Aa, Aa, Aa, Aa, Aa, Rb, Rb, Aa, Aa, Aa^Es, Aa, Aa, Aa^Fpa, Aa^Fpa
Aa, Aa, Aa, Aa, Aa^Voa, Aa, Rr, Rr, Rb, Aa, Aa, Aa, Aa, Aa, Aa, Aa^Fpa, Aa
Aa, Aa, Aa, Aa, Aa, Aa, Rr, Rb, Coa, 3 Koa, Coa, Aa, Aa, Aa, Aa, Aa, Aa
Coa, Coa, Coa, Aa, Aa, Aa^Es, Aa, Aa, Aa, Coa, Rb, Aa, Aa, Aa^Fpa, Aa, Aa, Aa
Aa, Aa, Aa, Coa, Coa, Aa, Aa, Aa, Aa, Rb, Rr, Rr, Aa, Aa, Aa, Aa, Aa
Aa, Aa, Aa, Aa, Aa, Aa, Aa, Aa, Aa, Aa, Aa, Aa, Aa, Coa, Coa, Coa, Coa
Aa, Aa, Aa, Aa, Aa, Aa, Aa, Aa, Aa, Aa, Aa, Aa, Aa, Aa, Aa, Aa, Aa
Aa, Aa^Es, Aa, Aa, Aa, Aa, Rb, Aa, Aa^Es, Aa, Aa, Aa, Aa, Aa, Aa, Aa, Aa
Aa, Aa, Aa, Aa, Aa, Aa, 2 Rb, Aa, Aa, Aa, Aa, Aa, Aa, Aa, Aa, Aa, Aa
Aa, Aa, Aa, Aa, Aa, Rb, Rb^Es, Rr, Aa, Aa, Aa, Aa, Aa, Aa, Aa, Aa, Aa
Aa, Aa, Aa, Aa, Aa, Rb, Rb, Rb, Aa, Aa, Aa, Aa, Aa, Aa, Aa, Aa, Aa
