Uu, Xu, Xu, Uu, Ur, Uu, Urb, Urb, Urb, Urb, Urb, Rb^Uf, Tb^Tf, Rb^Uf, Xu, Xu, Xu, Uu, Uu^Vu, Uu, Uu, Xu
Xu, Xu, Xu, Uu, Xu, Ur, Ur, Rb, Rb, Rb, Urb, Tb^Tf, Tb^Tf, Tb^Tf, Xu, Xu, Xu, Xu, 1 Uu, Xu, Xu, Xu
Xu, Xu, Uh, Uu, Uu, Ur, Xu, Rb, Uu, Uu, Rb, 2 Rb, Tb^Tf, Uu, Uu, Xu, Xu, Xu, Xu, Xu, Xu, Xu
Xu, Xu, Uu, Ur, Ur, Uu, Xu, Uu, Xu, Tb^Tf, Uu, Ur, Rb, Rb, Uu, Uu, Uh, Xu, Uh, Uu, Xu, Xu
Xu, Uh, Uu, Ur, Uu, Xu, Xu, Xu, Xu, Xu, Uu, Uu, Ur, Rb, Urb, Uu, Uu, Uu, Uu, Uu, Uu, Xu
Xu, Uu, Uu, Ur, Uu, Xu, Xu, Xu, Qxu, Xu, Uu, Uu, Ur, Urb, Urb, Xu, Xu, Xu, Uu, Ur, Uu, Uu
Uh, Rb, Rb, Uu, Xu, Xu, Xu, Xu, Uu, Ur, Xoa, Uu, Uu, Urb, Urb, Urb, Uu, Uu, Xu, Uu, Ur, Ur
Rb, Uu, Uu, Xu, Xu, Xu, Xu, Xu, Ur, Uu, Uu, Xoa, Uu, Rb, Uu^Dr, Uu, Xoa, Uu, Uu, Xu, Uu, Uu
Uu, Uu, Uu, Xu, Xu, Xu, Xoa, Xoa, Xoa, Ur, Ias, Xoa, Ias, Rb, Uu, Uu, Xoa, Xoym, Xu, Xu, Xu, Xu
Uu, Xu, Xu, Xuc, Uu, Xoa, Ias^Em, Xoa, Ias, Ias, Ias, Cpy, Ias, Ias, Uu, Uu, Uu, Xoa, Xos, Xu, Xu, Xu
Rb, Rb, Uh, Uh, Xoa, Uu, Uu, Ias, Ias, Ias, Mybd, Mybd, Mybd, Ias, Ias, Uu^Tf, Ias, Xoa, Xu, Xos, Xu, Uu
Xu, Xu, Uu, Uu, Xoa, Ias, Ias, Ias, Mybd, Mybd, Myb, Myb, Myb, Mybd, Mybd, Ias, Uu, Uu, Uh, Xoa, Uu, Ur
Xu, Xu, Uu, Xoa, Xoa, Ias, Xoa, Cay, Mybd, Myb, Myb, Myb, Myb, Myb, Mybd, Cay, Uu, Xoa, Uu, Tb^Tf, Ur, Uu
Xu, Xu, Ur, Ur, Rb, Urb, Xoa, Ias, Ias^Edb, Mybd, Mybd, Myb, Mybd^Es, Mybd, Ias, Ias, Ias, Xoa, Rb, Uu, Xu, Xu
Xu, Rb, Ur, Uu, Xoa, Urb, Tb^Tf, Uu, Xoa, Ias, Ias, Mybd, Ias^Edb, Ias, Xoa, Ias, Xoa, Uu, Urb, Uu, Xu, Xu
Rb, Xu, Ur, Xoa, Xoa, Urb, Tb^Tf, Xoa, Uu^Vu, Uu, Xoa, Ias, Ias, Ias, Xoa, Ias, Xoa, Uu, Urb, Uu, Xu, Xu
Xu, Xu, Ur, Xoa, Xu, Urb, Xoa, Xoa, Uu, Xoa, Xu, Uh, Urb, Uu, Uu, Xoa, Xoa, Rb, Urb, Uu, Xu, Xu
Uu, Xu, Uu, Uu, Urb, Urb, Xu, Xu, Uu, Xoa, Uu, Uh, Xu, Xu, Uu^Vu, Xu, Xu, Urb, Uh, Uh, Xu, Xu
Uu, Xu, Tb^Tf, Uu, Urb, Urb, Xu, Xu, Uu, Uu, Uu, Urb, Xu, Uu, Uu, Xu, Xu, Ur, Uh, Uu, Xu, Ur
Xu, Xu, Uu, Uu, Urb, Xu, Uh, Uh, Xu, Urb, Xu, Xu, Xu, Xu, Rb, Xu, Xu, Ur, Ur, Uu, Ur, Ur
Xu, Xu, Uu, Uu, Urb, Xu, Uh, Uh, Xu, Urb, Xu, Xu, Urb, Urb, Xu, Xu, Xu, Uu, Ur, Ur, Ur, Uu
Xu, Xu, Ur, Uu, Uu, Rb, Xu, Xu, Uu, Urb, Xu, Rb, Uu, Xu, Xu, Xu, Uu, Ur, Ur, Uu, Uu, Uu
