Uu, Xu, Xu, Uu, Ur, Uu, Urb, Urb, Urb, Urb, Urb, Rb^Uf, Rb^Uf, Rb^Uf, Xu, Xu, Xu, Uu, Uu^Vu, Uu, Uu, Xu
Xu, Xu, Xu, Uu, Xu, Ur, Ur, Rb, Rb, Rb, Urb, Rb^Uf, Rb^Uf, Rb^Uf, Xu, Xu, Xu, Xu, 1 Uu, Xu, Xu, Xu
Xu, Xu, Uh, Uu, Uu, Ur, Xu, Rb, Uu, Uu, Rb, 2 Rb, Rb^Uf, Uu, Uu, Xu, Xu, Xu, Xu, Xu, Xu, Xu
Xu, Xu, Uu, Ur, Ur, Uu, Xu, Uu, Xu, Uu^Uf, Uu, Ur, Rb, Rb, Uu, Uu, Uh, Xu, Uh, Uu, Xu, Xu
Xu, Uh, Uu, Ur, Uu, Xu, Xu, Xu, Xu, Xu, Uu, Uu, Ur, Rb, Urb, Uu, Uu, Uu, Uu, Uu, Uu, Xu
Xu, Uu, Uu, Ur, Uu, Xu, Xu, Xu, Qxu, Xu, Uu, Uu, Ur, Urb, Urb, Xu, Xu, Xu, Uu, Ur, Uu, Uu
Uh, Rb, Rb, Uu, Xu, Xu, Xu, Xu, Uu, Ur, Xoym, Uu, Uu, Urb, Urb, Urb, Uu, Uu, Xu, Uu, Ur, Ur
Rb, Uu, Uu, Xu, Xu, Xu, Xu, Xu, Ur, Uu, Uu, Xoym, Uu, Rb, Rb, Uu, Xoym, Uu, Uu, Xu, Uu, Uu
Uu, Uu, Uu, Xu, Xu, Xu, Xoym, Xoym, Xoym, Ur, Uu, Xoym, Uu, Rb, Uu, Uu, Xoym, Xoym, Xu, Xu, Xu, Xu
Uu, Xu, Xu, Xu, Uu, Xoym, Uu, Xoym, Uu, Ur, Brym, Cpy, Brym, Rb, Uu, Uu, Uu, Xoym, Xos, Xu, Xu, Xu
Rb, Rb, Uh, Uh, Xoym, Uu, Uu, Uu, Brym, Brym, Mybd, Mybd, Mybd, Brym, Brym, Uu^Uf, Uu, Xoym, Xu, Xos, Xu, Uu
Xu, Xu, Uu, Uu, Xoym, Urb, Brym, Brym, Mybd, Mybd, Myb, Myb, Myb, Mybd, Mybd, Brym, Uu, Uu, Uh, Xos, Uu, Ur
Xu, Xu, Uu, Xoym, Xu, Urb, Xoym, Cmy, Mybd, Myb, Myb, Myb, Myb, Myb, Mybd, Cmy, Uu, Xoym, Uu, Uu^Uf, Ur, Uu
Xu, Xu, Ur, Ur, Rb, Urb, Xoym, Brym, Brym, Mybd, Mybd, Myb, Mybd, Mybd, Brym, Brym, Uu, Xoym, Rb, Uu, Xu, Xu
Xu, Rb, Ur, Uu, Xos, Urb, Rb^Uf, Uu, Xoym, Brym, Brym, Mybd, Brym, Brym, Xoym, Urb, Xos, Uu, Urb, Uu, Xu, Xu
Rb, Xu, Ur, Xos, Xos, Urb, Rb^Uf, Xoym, Uu^Vu, Uu, Xos, Brym, Urb, Uu, Xoym, Urb, Xos, Uu, Urb, Uu, Xu, Xu
Xu, Xu, Ur, Xos, Xu, Urb, Xos, Xos, Uu, Xos, Xu, Uh, Urb, Uu, Uu, Xos, Xos, Rb, Urb, Uu, Xu, Xu
Uu, Xu, Uu, Uu, Urb, Urb, Xu, Xu, Uu, Xos, Uu, Uh, Xu, Xu, Uu^Vu, Xu, Xu, Urb, Uh, Uh, Xu, Xu
Uu, Xu, Rb^Uf, Uu, Urb, Urb, Xu, Xu, Uu, Uu, Uu, Urb, Xu, Uu, Uu, Xu, Xu, Ur, Uh, Uu, Xu, Ur
Xu, Xu, Uu, Uu, Urb, Xu, Uh, Uh, Xu, Urb, Xu, Xu, Xu, Xu, Rb, Xu, Xu, Ur, Ur, Uu, Ur, Ur
Xu, Xu, Uu, Uu, Urb, Xu, Uh, Uh, Xu, Urb, Xu, Xu, Urb, Urb, Xu, Xu, Xu, Uu, Ur, Ur, Ur, Uu
Xu, Xu, Ur, Uu, Uu, Rb, Xu, Xu, Uu, Urb, Xu, Rb, Uu, Xu, Xu, Xu, Uu, Ur, Ur, Uu, Uu, Uu
