Ms^Xm, Ms^Xm, Ms^Xm, Ha, Ms^Xm, Ha, Ms^Xm, Ms^Xm, Ms^Xm, Ms^Xm, Ms^Xm, Ms^Xm, Ms^Xm, Ms^Xm, Ms^Xm, Ms^Xm, Ms^Xm, Mm, Rp, Rp, Rp, Rp, Ur, Uh, Ql, Uh, Uh, Mm, Mm, Ha, Ms^Xm, Ha, Ms^Xm, Ha, Ms^Xm, Ms^Xm, Ms^Xm, Ha, Ms^Xm, Ha, Ms^Xm, Ha, Ms^Xm, Ms^Xm, Ms^Xm, Ha
Aa, Ms, Ms, Ms^Xm, Ms, Ms^Xm, Ms, Ms, Ms, Ms, Ms, Ms, Ms, Ms^Xm, Ms, Ms^Xm, Aa^Voa, Rp, Rp, Rp, Rp, Rp, Ur, Uh, Uh, Uh, Ur, Aa, Ms, Ms^Xm, Ms, Ms^Xm, Ms, Ms^Xm, Ms, Ms^Xm, Ms, Ms^Xm, Ms^Xm, Ms^Xm, Ms^Xm, Ms^Xm, Ms^Xm, Ms^Xm, Ms^Xm, Ms^Xm
Aa, Aa, Aa, Ms, Aa, Ms, Ms, Ms, Ha, Ms, Ha, Ms, Ms, Ms, Ms, Ms, Aa, Re, Rd, Rp, Coa, Coa, 2 Koa, Ur^Dr, Ur^Dr, Ur, Coa, Aa, Aa, Ms, Ms, Ms, Ms, Ms, Ms, Ms, Ms, Ms, Ms, Ms^Xm, Ms^Xm, Ms^Xm, Ms^Xm, Ms^Xm, Ms^Xm, Ms^Xm
Aa, Aa, Aa, Aa, Aa, Aa, Ms, Ha, Ha, Ha, Ha, Ha, Ha, Ms, Ha, Ha, Aa^Fpa, Re, Rd, Rd, Coa, Coa, Coa, Rp^Dr, Aa^Fpa, Aa, Aa^Fpa, Aa^Fpa, Aa, Ha, Ha, Ha, Ha, Ha, Ha, Ha, Aa, Ms, Ha, Ms, Ms, Ms^Xm, Ms^Xm, Ms^Xm, Ms^Xm, Ms^Xm
Aa, Aa, Aa, Aa, Aa, Aa, Aa, Ms, Ha, Aa^Fpa, Ha, Ha, Ha, Ha, Aa, Aa^Fpa, Aa^Fpa, Aa^Voa, Re, Rd, Re, Aa, Aa^Fpa, Aa^Fpa, Aa^Fpa, Aa, Aa, Aa, Aa, Aa, Aa, Aa, Aa, Ha, Aa, Aa, Aa, Aa, Aa, Ha, Ms, Ms, Ms, Ms^Xm, Ms^Xm, Ms^Xm
Aa, Aa, Aa, Aa, Aa, Aa, Aa, Ha, Ha, Ha, Aa^Fpa, Aa^Fpa, Aa, Aa^Fpa, Aa, Aa, Aa, Aa, Re, Spay, Aa, Aa^Fpa, Tyb, Tyb, Aa^Fpa, Tyb, Aa, Aa, Aa^Fpa, Aa, Aa, Aa, Aa, Aa, Aa, Aa, Dyb, Dyb, Dyb, Aa, Ha, Ms, Ms, Ms, Ms, Ms^Xm
Aa, Ywsd, Aa, Aa, Aa, Aa, Aa, Aa, Aa^Fpa, Ha, Ha, Aa^Fpa, Aa, Aa, Aa, Aa, Aa, Aa, Spay, Spay, Aa, Aa, Aa, Aa^Fpa, Aa, Aa, Aa, Aa, Aa^Fpa, Ha, Ha, Aa, Aa, Aa, Aa, Aa, Aa, Dyb, Aa, Aa, Aa, Ha, Ha, Ms, Ms, Ms
Ywsd, Ywsd, Ywsd, Aa, Aa, Aa, Aa, Aa, Aa, Aa^Fpa, Aa^Fpa, Aa^Fpa, Aa, Aa, Aa, Aa, Aa, Aa, Aa, Spay, Aa, Aa, Aa, Aa, Aa, Aa, Aa, Aa, Aa, Ha, Aa, Aa, Aa, Aa, Aa, Aa, Aa, Aa, Aa, Aa, Dyb, Aa, Aa, Ha, Ms, Ms
Ywsd, Ywsd, Ywsd, Aa, Aa, Aa, Aa, Aa, Aa, Aa, Aa, Aa, Aa, Aa, Aa, Aa, Aa, Aa, Aa^Fpa, Spay, Spay, Aa, Aa, Aa, Aa, Aa, Aa, Aa, Aa, Aa, Aa, Aa, Aa, Aa, Aa, Aa, Aa, Aa, Aa, Dyb, Dyb, Dyb, Aa, Ha, Ms, Ms
Ywsd, Ywsd, Ywsd, Ywsd, Ywsd, Aa, Aa, Aa, Aa, Aa, Aa, Aa, Aa, Aa, Aa, Aa, Aa^Fpa, Aa^Fpa, Aa, Spay, Spay, Aa, Aa, Aa, Aa, Aa, Aa, Aa, Aa, Aa, Aa, Aa, Aa, Aa, Aa, Aa, Aa, Aa, Aa, Aa, Dyb, Aa, Aa, Ha, Ha, Ms
Ywsd, Ywsd, Ywsd, Ywsd, Ywsd, Ywsd, Aa, Aa, Aa, Aa, Aa, Aa, Aa, Aa, Aa, Aa^Fpa, Tyb, Tyb, Aa, Aa^Fpa, Spay, Spay, Spay, Aa, Aa, Aa, Aa, Aa, Aa, Aa, Aa, Aa, Aa, Aa, Aa, Aa, Aa, Aa, Aa, Dyb, Dyb, Dyb, Aa, Aa, Ha, Ms
Ywsd, Ywsd, Ywsd, Ywsd, Ywsd, Ywsd, Ywsd, Aa, Aa, Aa, Aa, Aa, Aa, Aa, Aa, Aa^Fpa, Aa^Fpa, Tyb, Aa^Fpa, Spay, Ha, Ha, Ha, Spay, Spay, Aa, Aa, Aa, Aa, Aa, Aa, Aa, Ywsd, Aa, Aa, Aa, Aa, Aa, Aa, Aa, Aa, Aa, Aa, Aa, Aa, Ha
Ywsd, Ywsd, Ywsd, Ywsd, Ywsd, Ywsd, Ywsd, Aa, Aa, Aa, Aa, Aa, Aa, Aa, Aa, Aa, Aa, Aa^Fpa, Spay, Spay, Ha, Ha, Aa, Spay, Spay, Aa, Aa, Aa, Aa, Aa, Ywsd, Ywsd, Ywsd, Ywsd, Ywsd, Aa, Ywsd, Ywsd, Aa, Aa, Aa, Aa, Aa, Aa, Aa, Ha
Ywsd, Ywsd, Ywsd, Ywsd, Ywsd, Ywsd, Aa, Aa, Aa, Aa, Aa, Aa, Aa, Aa, Aa, Aa, Spay, Spay, Aa, Aa, Aa, Ha, Aa, Aa, Spay, Aa, Aa, Aa, Aa, Aa, Ywsd, Ywsd, Ywsd, Ywsd, Ywsd, Ywsd, Ywsd, Ywsd, Ywsd, Aa, Aa, Aa, Aa, Aa, Aa, Ha
Ywsd, Ywsd, Ywsd, Ywsd, Aa, Aa, Aa, Aa, Aa, Aa, Aa, Aa, Dyb, Dyb, Dyb, Aa, Spay, Spay, Aa, Aa, Aa, Aa, Aa, Aa, Spay, Aa, Aa, Aa, Aa, Aa, Ywsd, Ywsd, Ywsd, Ywsd, Ywsd, Ywsd, Ywsd, Ywsd, Ywsd, Ywsd, Aa, Aa, Aa, Aa, Aa, Ha
Ywsd, Ywsd, Aa, Aa, Aa, Aa, Aa, Aa, Aa, Aa, Aa, Aa, Aa, Aa, Aa, Aa, Aa^Fpa, Aa, Aa, Aa, Aa, Aa, Aa, Aa, Spay, Aa, Aa, Aa, Aa, Aa, Ywsd, Ywsd, Ywsd, Ywsd, Ywsd, Ywsd, Ywsd, Ywsd, Ywsd, Ywsd, Ywsd, Aa, Aa, Aa, Aa, Ha
Aa, Ywsd, Aa, Aa, Aa, Aa, Aa, Aa, Aa, Aa, Aa, Aa, Aa, Aa, Aa, Aa^Fpa, Tyb, Aa^Fpa, Aa^Fpa, Aa, Aa, Aa, Aa, Aa, Spay, Aa, Aa, Aa, Aa, Aa, Aa, Ywsd, Ywsd, Ywsd, Ywsd, Ywsd, Ywsd, Ywsd, Ywsd, Ywsd, Ywsd, Ywsd, Ywsd, Aa, Aa, Aa
Aa, Aa, Aa, Aa, Aa, Aa, Aa, Aa, Ha, Ha, Ha, Aa, Aa, Aa, Aa^Fpa, Tyb, Tyb, Tyb, Aa, Aa, Aa, Aa, Spay, Spay, Aa, Aa, Aa, Aa, Aa, Aa, Aa, Aa, Aa, Ywsd, Ywsd, Ywsd, Ywsd, Ywsd, Ywsd, Ywsd, Ywsd, Ywsd, Ywsd, Ywsd, Ywsd, Ywsd
Aa, Aa, Aa, Aa, Aa, Aa, Aa, Aa, Aa, Ha, Aa, Aa, Aa, Aa, Aa, Tyb, Tyb, Tyb, Aa, Aa, Aa, Aa, Aa, Aa, Aa, Aa, Aa, Aa, Aa, Aa, Aa, Aa, Aa, Aa, Ywsd, Ywsd, Ywsd, Ywsd, Ywsd, Ywsd, Ywsd, Ywsd, Ywsd, Ywsd, Ywsd, Ywsd
Aa, Aa, Aa, Aa, Aa, Aa, Aa, Aa, Aa, Aa, Aa, Aa, Aa, Aa, Aa, Aa^Fpa, Aa^Fpa, Aa, Aa, Aa, Aa, Aa, Aa, Aa, Aa, Aa, Aa, Aa, Aa, Aa, Aa, Aa, Ywsd, Ywsd, Ywsd, Ywsd, Ywsd, Ywsd, Ywsd, Ywsd, Ywsd, Ywsd, Ywsd, Ywsd, Ywsd, Ywsd
Aa, Aa, Aa, Aa, Aa, Aa, Aa, Aa, Aa, Aa, Aa, Aa, Aa, Aa, Aa, Aa, Spay, Aa, Aa, Aa, Aa, Aa, Dyb, Aa, Aa, Aa, Aa, Aa, Aa, Aa, Ywsd, Ywsd, Ywsd, Ywsd, Ywsd, Ywsd, Ywsd, Ywsd, Ywsd, Ywsd, Ywsd, Ywsd, Ywsd, Ywsd, Ywsd, Ywsd
Aa, Aa, Aa, Aa, Aa, Aa, Aa, Aa, Aa, Dyb, Dyb, Aa, Aa, Aa, Spay, Spay, Aa, Aa, Aa, Aa, Dyb, Dyb, Aa, Aa, Aa, Aa, Aa, Aa, Ywsd, Ywsd, Ywsd, Ywsd, Ywsd, Ywsd, Ywsd, Ywsd, Ywsd, Ywsd, Ywsd, Ywsd, Ywsd, Ywsd, Ywsd, Ywsd, Ywsd, Ywsd
Aa, Aa, Aa, Aa, Aa, Aa, Aa, Aa, Aa, Aa, Aa, Aa, Spay, Spay, Aa, Aa, Dyb, Aa, Aa, Aa, Aa, Aa, Aa, Aa, Aa, Aa, Aa, Aa, Ywsd, Ywsd, Ywsd, Ywsd, Ywsd, Ywsd, Ywsd, Ywsd, Ywsd, Ywsd, Ywsd, Ywsd, Ywsd, Ywsd, Ywsd, Ywsd, Ywsd, Ywsd
Aa, Aa, Aa, Aa, Aa, Aa, Aa, Aa, Aa, Aa, Spay, Spay, Aa, Aa, Aa, Aa, Aa, Aa, Ha, Aa, Aa, Aa, Aa, Aa, Dyb, Aa, Aa, Aa, Aa, Ywsd, Ywsd, Ywsd, Ywsd, Ywsd, Ywsd, Ywsd, Ywsd, Ywsd, Ywsd, Ywsd, Ywsd, Ywsd, Ywsd, Ywsd, Ywsd, Ywsd
Aa, Aa, Aa, Aa, Aa, Aa, Aa, Aa, Aa, Aa, Spay, Spay, Aa, Aa, Ms, Ms, Ms, Ms, Ha, Ha, Aa, Aa, Aa, Dyb, Dyb, Dyb, Aa, Aa, Aa, Aa, Aa, Aa, Aa, Ywsd, Aa, Ywsd, Aa, Ywsd, Ywsd, Ywsd, Ywsd, Ywsd, Ywsd, Ywsd, Ywsd, Ywsd
Aa, Aa^Aybl, Aa^Aybl, Aa^Aybl, Aa, Aa, Aa, Aa, Aa, Aa, Ms, Ms, Ms, Ms, Ha, Ha, Ha, Ha, Aa, Aa^Aybl, Ha, Aa, Aa, Aa, Aa, Dyb, Aa, Aa, Aa, Aa, Aa, Aa, Aa, Aa, Aa, Aa, Aa, Aa, Aa, Aa, Aa, Ywsd, Aa, Ywsd, Ywsd, Ywsd
Aa^Aybl, Aa^Aybl, Aa^Aybl, Aa^Aybl, Aa^Aybl, Aa, Aa, Aa, Aa, Spay, Ms, Aa^Fpa, Rrc, Spay, Aa^Fpa, Ha, Aa^Voa, Ha, Aa, Ha, Ha, Aa, Aa, Aa, Aa, Dyb, Aa, Aa, Aa, Aa, Aa, Aa, Aa, Aa, Aa, Aa, Aa, Aa, Aa, Aa, Aa, Aa, Aa, Aa, Aa, Aa
Ms, Aa^Aybl, Aa^Aybl, Aa^Aybl, Ms, Ha, Ha, Aa, Aa, Spay, Ms, Rrc, Ms, Rrc, Rrc, Aa, Aa, Aa, Aa, Ha, Rrc, Ha, Rrc, Aa, Spay, Aa, Aa, Aa, Aa, Aa, Aa^Fpa, Aa, Aa, Aa, Aa, Aa, Aa, Aa, Aa, Aa, Aa, Aa, Aa, Aa, Aa, Aa
Ms, Aa^Aybl, Aa^Aybl, Ha, Ms^Xm, Ms^Xm, Ha, Aa, Aa, Spay, Spay, Rrc, Ms, Spay, Aa, Rrc, Rrc, Coa, Rrc, Rrc, Rrc, Rrc, Aa, Rrc, Spay, Aa, Aa, Aa^Fyak, Tyb, Tyb, Tyb, Aa, Aa, Dyb, Dyb, Aa, Aa, Aa, Aa, Aa, Aa, Aa, Aa, Aa, Aa, Aa
Aa, Ms, Aa, Aa^Aybl, Ms, Aa^Aybl, Ms^Xm, Aa, Aa^Aybl, Aa, Ms^Xm, Ms, Ha, Ha, Ha, Aa^Voa, Aa, Koa, Coa, Aa, Ha, Ha, Ha, Aa, Aa, Spay, Aa^Fpa, Tyb, Tyb, Tyb, Tyb, Aa^Fpa, Aa, Aa, Aa, Aa, Dyb, Aa, Dyb, Aa, Aa, Aa, Aa, Aa, Aa, Aa
Aa, Aa, Aa, Ha, Ha, Ms, Ms, Aa^Aybl, Aa^Aybl, Ha, Ms^Xm, Ha, Ha, Aa^Fyak, Ha, Ha, Aa^Fpa, Aa, Aa, Aa, Ha, Ms, Ha, Aa, Aa, Spay, Aa, Tyb, Tyb, Tyb, Aa^Fpa, Aa^Fpa, Spay, Aa, Aa, Aa, Aa, Aa, Aa, Dyb, Aa, Aa, Ms, Ms, Ms, Aa
Aa, Aa, Aa, Aa, Aa, Aa, Aa, Ha, Ms, Ms, Ms, Ms^Xm, Ms^Xm, Ha, Ha, Ha, Ha, Ha, Aa^Fpa, Aa^Voa, Aa, Ha, Aa^Aybl, Aa, Aa, Aa, Aa, Aa^Fpa, Spay, Aa, Aa, Spay, Spay, Spay, Spay, Spay, Aa, Aa, Aa, Aa, Ha, Ha, Ha, Ms, Ms, Ms
Aa, Aa, Aa, Aa, Aa, Aa, Aa, Aa, Aa, Ha, Aa, Ms, Aa^Aybl, Ms^Xm, Ms^Xm, Ms, Ms^Xm, Ha, Ms, Aa^Fpa, Ms, Aa, Ms, Ha, Ms, Aa, Aa, Ha, Ha, Spay, Aa, Aa, Aa, Aa, Aa, Spay, Aa, Aa, Aa, Aa, Ha, Ha, Aa^Voa, Ms, Ms, Ms
Aa, Aa, Aa, Aa, Aa, Aa, Aa, Aa, Aa, Aa, Aa, Aa^Aybl, Aa^Aybl, Ha, Ha, Ms^Xm, Aa^Aybl, Ms^Xm, Aa^Aybl, Ms, Aa^Aybl, Ha, Ms, Ms, Aa, Aa, Ha, Ms, Ha, Spay, Ha, Ha, Ha, Aa, Aa, Aa, Aa, Spay, Spay, Aa, Aa, Aa, Aa, Aa, Ms, Ms
Aa, Aa, Aa, Aa, Aa, Aa, Aa, Aa, Aa, Aa, Aa, Aa, Aa, Aa, Aa, Aa, Ms, Aa^Aybl, Ms, Ha, Ms, Ms, Ms, Ms, Ha, Ha, Ms, Ha, Spay, Spay, Ai, Ha, Ai, Ai, Ai, Aa, Ai, Aa, Aa, Aa, Aa^Fpa, Aa, Aa, Aa, Aa, Aa
Aa, Aa, Aa, Aa, Aa, Aa, Aa, Aa, Aa, Aa, Aa, Aa, Aa, Aa, Aa, Aa, Aa, Ms, Ha, Ha, Ms, Aa^Aybl, Ai, Ha, Ha, Ms, Ms, Ai, Spay, Ai, Aa, Ai, Ha, Aa, Ai, Ai, Ai, Ai, Aa^Fpa, Aa^Fpa, Aa^Fpa, Aa, Aa, Dyb, Aa, Aa
Ywsd, Aa, Aa, Aa, Aa, Aa, Aa, Aa, Aa, Aa, Aa, Aa, Aa, Aa, Aa, Ha, Ms, Aa^Aybl, Ms, Ms, Ms, Aa, Spay^Edt, Ai, Aa, Ha, Spay, Spay, Ha, Ha, Ha, Ha, Ms^Xm, Ha, Ha, Aa, Ai, Aa^Fyak, Tyb, Tyb, Tyb, Aa^Fpa, Aa, Aa, Aa, Aa
Ywsd, Ywsd, Ywsd, Aa, Aa, Aa, Aa, Aa, Aa, Aa, Aa, Aa, Aa, Aa, Aa, Aa, Ha, Ha, Aa, Ai, Ai^Edb, Spay^Edb, Spay^Edb, Spay, Aa, Aa, Spay, Aa, Ha, Ha, Aa^Aybl, Ms^Xm, Ms^Xm, Ms^Xm, Ha, Ai, Aa, Aa^Fpa, Tyb, Tyb, Tyb, Aa^Fpa, Aa, 3 Aa, Aa, Aa
Ywsd, Ywsd, Ywsd, Ywsd, Ywsd, Aa, Aa, Aa, Aa, Aa, Aa, Aa, Aa, Aa, Aa, Aa, Aa, Aa, Aa, Aa, Ha, Spay^Edb, Ha, Ha, Ha, Ms, Aa^Aybl, Spay, Spay, Ha, Aa^Aybl, Ms^Xm, Ms^Xm, Ms^Xm, Ha, Ai, Aa, Aa, Spay, Tyb, Aa, Aa^Fpa, Aa, Aa, Aa, Aa
Ywsd, Ywsd, Ywsd, Ywsd, Ywsd, Ywsd, Ywsd, Aa, Aa, Aa, Aa, Aa, Aa, Aa, Aa, Aa, Ha, Aa, Ha, Ha, Ms, Ha, Ms^Xm, Ha, Ms^Xm, Ha, Ha, Ai, Spay, Ai, Ha, Ms^Xm, Ha, Ms^Xm, Ha, Ai, Spay, Spay, Aa, Aa, Aa, Aa, Aa, Aa, Aa, Aa
Ywsd, Ywsd, Ywsd, Ywsd, Ywsd, Ywsd, Ywsd, Ywsd, Ywsd, Aa, Aa, Aa, Aa, Dyb, Aa, Ha, Ms, Ha, Aa^Aybl, Aa^Aybl, Ms, Ms^Xm, Ms^Xm, Aa^Aybl, Ms^Xm, Ms^Xm, Ms^Xm, Ha, Ha, Spay, Spay, Ha, Aa, Ha, Ai, Spay, Spay, Spay, Aa, Dyb, Aa, Aa, Aa, Dyb, Aa, Aa
Ywsd, Ywsd, Ywsd, Ywsd, Ywsd, Ywsd, Ywsd, Ywsd, Ywsd, Ywsd, Aa, Aa, Ha, Ms, Ha, Ha, Ha, Ms, Ms, Ms, Ms, Aa^Aybl, Ms, Ms, Ms, Ms, Ms, Ms^Xm, Ha, Ha, Spay, Aa^Aybl, Aa, Ai, Aa, Spay, Aa, Aa, Aa, Aa, Aa, Aa, Aa, Aa, Aa, Aa
Ywsd, Ywsd, Ywsd, Ywsd, Ywsd, Ywsd, Ywsd, Ywsd, Aa, Aa, Aa, Aa, Aa, Ms, Ha, Ha, Ms, Ms, Aa^Aybl, Ms, Ms, Ms, Ms, Ms, Ms^Xm, Ms^Xm, Ms, Ms, Ha, Spay, Spay, Aa, Spay, Aa, Spay, Spay, Spay, Aa, Aa, Aa, Aa, Aa, Aa, Aa, Aa, Aa
Ywsd, Ywsd, Ywsd, Ywsd, Ywsd, Ywsd, Ywsd, Ywsd, Aa, Aa, Aa, Ha, Aa, Aa, Aa, Aa^Aybl, Ha, Aa^Aybl, Ms, Aa^Aybl, Ha, Ms, Ms, Ms, Aa^Aybl, Ms, Ha, Ha, Spay, Spay, Spay, Spay, Aa, Spay, Aa, Aa, Spay, Aa, Aa, Aa, Aa, Aa, Aa, Aa, Aa, Aa
Ywsd, Ywsd, Ywsd, Ywsd, Ywsd, Ywsd, Aa, Aa, Aa, Aa, Aa, Aa, Aa, Aa, Aa, Aa, Aa, Ha, Ha, Ha, Ha, Ms, Ha, Ms, Ms, Ha, Aa^Voa, Aa, Aa^Fpa, Aa, Aa, Aa, Aa, Aa, Dyb, Aa, Aa, Spay, Aa, Aa, Dyb, Aa, Aa, Aa, Aa, Aa
Ywsd, Ywsd, Ywsd, Ywsd, Aa, Aa, Aa, Aa, Aa, Aa, Aa, Aa, Aa, Dyb, Aa, Aa, Aa, Aa, Aa, Ha, Ha, Ha, Spay, Ha, Ha, Ha, Aa, Aa, Tyb, Tyb, Aa^Fpa, Aa, Aa, Dyb, Dyb, Dyb, Aa, Aa, Aa, Aa, Dyb, Dyb, Aa, Aa, Aa, Aa
Ywsd, Ywsd, Aa, Aa, Aa, Aa, Aa, Aa, Aa, Aa, Aa, Aa, Aa, Aa, Ha, Aa, Aa, Spay, Spay, Aa, Spay, Aa, Aa, Spay, Spay, Ha, Aa, Aa^Fpa, Tyb, Tyb, Aa^Fpa, Aa, Aa, Aa, Aa, Aa, Aa, Spay, Aa, Aa, Aa, Aa, Aa, Aa, Aa, Aa
Aa, Aa, Aa, Aa, Aa, Aa, Aa, Aa, Ha, Aa, Ha, Aa^Fpa, Aa, Aa, Aa^Fpa, Aa^Fpa, Aa^Fpa, Spay, Spay, Spay, Aa, Spay, Aa, Aa, Aa, Spay, Spay, Aa^Fyak, Aa^Fpa, Aa^Fpa, Aa, Aa, Ha, Ha, Aa, Aa, Aa, Spay, Spay, Aa, Aa, Aa, Aa, Aa, Aa, Aa
Aa, Aa, Aa, Aa, Aa, Aa, Aa, Aa^Fpa, Aa^Fpa, Aa^Fpa, Ai, Ai, Ai, Aa^Fpa, Tyb, Tyb, Tyb, Aa, Aa, Aa, Aa, Aa, Aa, Aa, Aa, Aa, Aa, Aa, Aa, Aa, Aa, Aa, Aa, Ha, Aa, Aa, Aa^Fpa, Aa, Spay, Cha, Aa, Aa, Aa, Aa, Aa, Aa
Aa, Aa, Aa, Aa, Aa, Aa, Aa^Fyak, Aa^Fpa, Tyb, Tyb, Ai, Wwg, Aa^Fpa, Aa^Fpa, Aa^Fpa, Tyb, Aa^Fpa, Aa, Aa, Aa, Aa, Aa, Ha, Aa^Fpa, Ha, Aa, Aa, Aa, Ha, Aa, Aa, Aa, Aa, Aa, Aa, Aa, Aa^Fpa, Aa^Fpa, Tyb, Aa, Cha, Aa, Aa, Aa, Aa, Aa
Aa, Aa, Aa, Aa, Aa, Aa, Aa^Fpa, Aa^Fpa, Tyb, Tyb, Aa^Fpa, Aa, Spay, Aa, Spay, Aa^Fpa, Aa, Dyb, Dyb, Aa, Ha^Fpa, Ha, Aa^Aybl, Ha, Ms^Xm, Ms^Xm, Ms^Xm, Ha, Aa^Aybl, Ha, Aa, Aa, Aa, Aa, Spay, Aa, Aa^Fyak, Tyb, Tyb, Aa^Fpa, Chr, Ha, Aa, Aa, Aa, Aa
Aa, Aa, Aa, Ha, Aa, Aa, Aa^Fpa, Tyb, Tyb, Tyb, Spay, Spay, Aa, Spay, Aa, Spay, Aa, Aa, Aa, Aa, Ha, Ha, Ms, Ms, Ms, Ms, Ms, Ms, Ms, Ha, Aa, Ha, Aa, Aa, Aa, Spay, Spay, Aa^Fpa, Tyb, Chr, Aa^Fpa, Ha, Aa, Aa, Aa, Aa
Ywsd, Aa, Aa, Aa, Aa, Aa, Aa, Aa^Fpa, Aa^Fpa, Aa^Fpa, Spay, Aa, Spay, Spay, Spay, Aa, Aa, Aa, Aa, Aa, Ha, Ha, Ha, Ha, Ha, Ha, Aa, Ha, Aa, Ha, Aa, Aa, Aa, Aa, Spay, Aa, Spay, Aa^Fpa, Aa^Fpa, Aa^Fpa, Aa, Aa, Aa, Aa, Aa, Aa
Ywsd, Aa, Aa, Aa, Aa, Aa, Aa, Ha, Aa, Aa, Aa, Spay, Aa, Spay, Aa, Spay, Aa, Spay, Spay, Aa, Aa, Ha, Aa, Ha, Aa, Aa, Aa, Aa, Aa, Aa, Aa, Aa, Aa, Aa, Spay, Spay, Aa, Aa, Aa, Aa, Aa, Aa, Aa, Aa, Aa, Aa
Ywsd, Ywsd, Ywsd, Aa, Aa, Aa, Aa, Aa, Aa, Aa, Aa, Aa, Aa, Aa, Aa, Aa, Aa, Aa, Aa, Spay, Spay, Aa, Aa, Aa, Aa, Aa, Aa, Aa, Dyb, Dyb, Aa, Aa, Aa, Aa, Spay, Aa, Aa, Aa, Aa, Aa, Aa, Aa, Aa, Aa, Ywsd, Aa
Ywsd, Ywsd, Ywsd, Aa, Aa, Aa, Aa, Aa, Aa, Aa, Aa, Aa, Aa, Aa, Aa, Aa, Aa, Aa, Aa, Aa, Aa^Fyak, Aa^Fpa, Tyb, Aa^Fpa, Aa, Aa, Aa, Dyb, Dyb, Dyb, Dyb, Aa, Aa, Aa, Aa, Aa, Aa, Aa, Aa, Aa, Aa, Aa, Ywsd, Ywsd, Ywsd, Ywsd
Ywsd, Ywsd, Ywsd, Ywsd, Ywsd, Aa, Ywsd, Aa, Aa, Aa, Aa, Aa, Aa, Aa, Aa, Aa, Aa, Aa, Aa, Aa^Fpa, Aa, Aa^Fpa, Aa^Fpa, Tyb, Aa^Fpa, Aa, Aa, Aa, Aa, Aa, Aa, Aa, Spay, Spay, Aa, Aa, Aa, Aa, Aa, Aa, Aa, Ywsd, Ywsd, Ywsd, Ywsd, Ywsd
Ywsd, Ywsd, Ywsd, Ywsd, Ywsd, Ywsd, Ywsd, Ywsd, Aa, Aa, Aa, Aa, Aa, Aa, Aa, Aa, Aa, Aa, Aa, Aa, Aa, Aa, Aa, Aa, Aa, Spay, Spay, Aa, Aa, Aa, Aa, Spay, Aa, Aa, Aa, Aa, Aa, Aa, Aa, Aa, Aa, Ywsd, Aa, Ywsd, Ywsd, Ywsd
Ywsd, Ywsd, Ywsd, Ywsd, Ywsd, Ywsd, Ywsd, Ywsd, Aa, Aa, Aa, Aa, Aa, Aa, Aa, Aa, Aa, Aa, Aa, Aa, Aa, Aa, Aa, Aa, Aa, Aa, Re^Vct, Spay, Spay, Aa, Aa, Spay, Aa, Aa, Aa, Dyb, Dyb, Aa, Aa, Aa, Aa, Aa, Aa, Aa, Aa, Aa
Ywsd, Ywsd, Ywsd, Ywsd, Ywsd, Ywsd, Aa, Aa, Aa, Aa, Aa, Aa, Aa, Aa, Aa, Aa, Aa, Aa, Aa, Aa, Aa, Aa, Aa, Aa, Aa, Aa, Aa, Re, Ce, Re, Re, Re^Vct, Spay, Aa, Aa, Aa, Aa, Dyb, Aa, Aa, Aa, Aa, Aa, Aa, Aa, Aa
Ywsd, Ywsd, Ywsd, Ywsd, Aa, Aa, Aa, Aa, Aa, Aa, Aa, Aa, Ha, Aa, Ha, Aa, Ha, Aa, Aa, Aa, Ha, Aa, Ha, Aa, Aa, Aa, Ce, Ce, 1 Ke, Ce, Ce, Spay, Spay, Aa, Aa, Aa, Aa, Dyb, Aa, Aa, Ha, Ha, Ha, Aa, Ha, Ha
Aa, Ywsd, Aa, Aa, Aa, Aa, Ha, Ha, Ha, Ha, Ha, Ha, Ha, Ha, Ha, Ha, Ha, Ha, Ha, Aa, Aa, Ha, Aa, Ha, Aa, Aa, Aa, Ce, Aa, Ce, Re, Spay, Spay, Aa, Aa, Aa, Aa, Aa, Ha, Ha, Ha, Ha, Ha, Ha, Ha, Ha
