Zdyd, Zdyd, Zdyd, Zdyd, Zdyd, Zdyd, Zdyd, Zdyd, Zdyd, Zdyd, Zdyd, Zdyd, Zdyd, Zdyd, Zdyd, Zdyd, Zdyd, Zdyd, Zdyd, Zdyd, Zdyd, Zdyd, Zdyd, Zdyd, Zdyd, Zdyd, Zdyd, Zdyd, Zdyd, Zdyd, Zdyd, Zdyd, Zdyd, Zdyd, Zdyd, Zdyd, Zdyd, Zdyd, Zdyd, Zdyd, Zdyd, Zdyd
Zdyd, Zdyd, Zdyd, Zdyd, Zdyd, Zdyd, Zdyd, Zdyd, Zdyd, Zdyd, Zdyd, Zdyd, Zdyd, Zdyd, Zdyd, Zdyd, Zdyd, Zdyd, Zdyd, Zdyd, Ms^Xm, Zdyd, Zdyd, Zdyd, Zdyd, Zdyd, Zdyd, Zdyd, Zdyd, Zdyd, Zdyd, Zdyd, Zdyd, Zdyd, Zdyd, Zdyd, Zdyd, Zdyd, Zdyd, Zdyd, Zdyd, Zdyd
Zdyd, Zdyd, Zdyd, Zdyd, Zdyd, Zdyd, Zdyd, Zdyd, Zdyd, Zdyd, Zdyd, Zdyd, Zdyd, Zdyd, Zdyd, Zdyd, Zdyd, Zdyd, Ms^Xm, Ms^Xm, Ms, Ms^Xm, Ms^Xm, Ms^Xm, Ms^Xm, Zdyd, Ms, Zdyd, Ms, Zdyd, Ms, Zdyd, Zdyd, Zdyd, Zdyd, Zdyd, Zdyd, Zdyd, Zdyd, Zdyd, Zdyd, Zdyd
Zdyd, Zdyd, Zdyd, Zdyd, Zdyd, Zdyd, Zdyd, Zdyd, Zdyd, Zdyd, Zdyd, Zdyd, Zdyd, Zdyd, Zdyd, Zdyd, Ms, Ms, Cay, Ms, Cay^Yt/p, Cay, Cay, Ms^Xm, Cay, Ms^Xm, Cay, Cay, Cay^Yt\p, Cay, Cay, Cay, Cay, Zdyd, Zdyd, Zdyd, Zdyd, Zdyd, Zdyd, Zdyd, Zdyd, Zdyd
Zdyd, Zdyd, Zdyd, Zdyd, Zdyd, Zdyd, Zdyd, Zdyd, Zdyd, Zdyd, Zdyd, Zdyd, Zdyd, Zdyd, Ms, Ms, Cay, Cay, Cay^Ytwt, Cay, Cay, Cay, Cay^Esa, Cay, Cay, Cay, Cay, Cay, Cay, Cay, Cay, Cay^Ytot, Cay, Cay, Cay, Zdyd, Zdyd, Zdyd, Zdyd, Zdyd, Zdyd, Zdyd
Zdyd, Zdyd, Zdyd, Zdyd, Zdyd, Zdyd, Zdyd, Zdyd, Zdyd, Zdyd, Ms^Xm, Ms, Cay^Esa, Ms^Xm, Cay, Cay, Cay, Cay, Cay, Cay^Es, Cay, Cay, Cay, Cay, Ias, Ias, Rr, Cay, Rp, Cay, Rp, Cay, Cay, Cay, Cay, Ms, Ms, Zdyd, Zdyd, Zdyd, Zdyd, Zdyd
Zdyd, Zdyd, Zdyd, Zdyd, Ms, Zdyd, Zdyd, Zdyd, Ms^Xm, Ms, Cay, Cay, Cay, Cay, Cay, Cay, Cay, Cay, Ias, Cay, Rr, Ias, Ias, Ias, Ias, Ias, Rrc^Dr, Rr, Rr, Rp, Ias, Rp, Ias, Cay, Cay, Cay, Cay, Ms, Ms, Zdyd, Zdyd, Zdyd
Ms, Zdyd, Ms, Ms, Ha, Ms, Ms^Xm, Ms^Xm, Ms, Ms, Cay, Cay, Ias, Cay, Ias, Rr, Rr, Ias, Ias, Rr, Cay, Cay, Cay, Rr, Rrc, Rrc, Rrc, Rrc^Es, Rrc, Ias, Ias, Ias, Ias, Ias, Cay, Cay, Cay, Ha, Ms, Ms, Zdyd, Zdyd
Ms, Ms, Ha, Ha, Ha, Ha, Ms^Xm, Ms^Xm, Ms, Cay, Cay, Cay, Ias, Ias^Es, Ias, Rrc^Es, Rr^Es, Ias^Dr, Ias, Ias, Cay, Cay^Yalt, Cay, Ias, Ias, Rrc^Esa, Ias, Ias, Ias, Rr, Rp, Ias, Ias, Rp, Cay, Cay^Yt/p, Cay, Ha, Ha, Ms, Ms, Zdyd
Ms, Ms, Ms, Ha, Ha, Ha^Fpa, Ha^Fpa, Ms^Xm, Ms, Cay, Cay^Dr, Cay, Cay, Ias, Rr, Rr, Rr, Rr, Ymnt, Ias, Rp, Cay, Rr, Ias, Ias^Ecf, Ias, Cay, Ias, Rr, Rp^Es, Rp^Dr, Ias^Es, Ias, Ias, Cay, Cay, Cay, Ha, Ha, Ms, Ms, Ms
Ms, Ms, Ms, Ha, Ha, Ha^Fpa, Ha^Fpa, Ha^Fpa, Ha^Fpa, Cay, Cay, Cay^Es, Cay, Cay, Cay, Cay, Cay, Rr, Cay, Rr, Rrc, Rr, Ias, Ias, Ias, Cay, 2 Kay, Cay, Re^Vct, Rr, Ias, Ias^Es, Ias, Ias, Cay, Cay, Cay, Ha, Ha, Ha, Ms, Ms
Ms, Ms, Ms, Ms, Ms, Ha, Ha^Fpa, Ha^Fpa, Ha^Fpa, Ha^Qov, Ha^Qov, Cay, Cay, Cay, Cay, Cay^Es, Cay, Cay, Cay^Yt\p, Cay, Cay, Cay, Cay, Cay, Ias, Cay, Cay, Cay, Ias, Ias, Ias, Ias, Cay, Cay, Cay^Es, Cay^Es, Cay, Ha^Qov, Ha, Ha, Ms, Ms
Ms, Ha, Ms, Ms, Ms, Ha^Fpa, Ha, Ha^Fpa, Ha, Ha, Ha^Fpa, Ha^Qov, Ha^Qov, Ha^Qov, Ha^Qov, Cay, Ha^Qov, Cay, Cay, Cay, Cay, Cay^Ytot, Cay, Cay^Ebn, Ias, Ias, Ias, Ias, Ias, Rr, Cay, Cay, Cay^Es, Cay^Dr, Cay, Cay, Ha^Qov, Ha^Qov, Ha, Ha, Ms, Ha
Ms, Ha, Ha, Ms, Ms, Ha, Ha, Ha, Ha^Fpa, Ha, Ha, Ha, Ha, Ha, Ha, Ha^Qov, Ha, Ha^Qov, Ha^Qov, Cay, Ha^Qov, Cay, Ias, Ias, Ias, Ias, Cay, Cay, Cay, Cay, Cay, Cay^Esa, Cay, Cay, Cay, Cay, Ha^Qov, Ha, Ms, Ms, Ms, Ms
Ms, Ha, Ha, Ms, Ms, Ha, Ha, Ha, Ha, Ha, Ha, Ha, Ha^Fpa, Ha, Ha, Ms, Ms, Ha, Ha, Ha^Qov, Ha, Ha, Rrc, Ias, Rrc, Ias^Ebn, Cay, Cay^Ytwt, Cay^Esa, Cay^Yt/p, Cay, Cay, Ha^Qov, Ha^Qov, Ha^Qov, Ha^Qov, Ha, Ms, Ms, Ms, Ms, Ms
Mm^Xm, Ha, Ha, Ha, Rb, Ha, Aa^Fpa, Ha, Ha, Ha, Ha, Ha, Aa^Fpa, Ha, Ha, Ms, Ms, Ms, Ms, Ha, Ha, Rra, Rra, Rr, Rrc, Ha, Ha^Qov, Cay, Cay, Cay, Ha^Qov, Ha^Qov, Ha, Ha, Ha, Ha, Ms, Ms, Ms, Ms, Ms^Xm, Ms^Xm
Mm^Xm, Mm^Xm, Rb, Rb, Aa^Fpa, Aa^Fpa, Aa^Fpa, Aa^Fpa, Ms^Xm, Ms^Xm, Ms^Xm, Aa^Fpa, Aa^Fpa, Aa^Fpa, Aa^Fpa, Ha, Ha, Ms, Ha, Ha, Aa^Fpa, Aa^Fpa, Rr, Rr, Re^Vct, Ha, Ha, Ha^Qov, Ha^Qov, Ha^Qov, Ha, Ha, Ha, Ha, Ha^Fpa, Ms, Ms, Ms, Ms, Ms^Xm, Ms^Xm, Ms^Xm
Rb, Rb, Rb, Ha, Aa^Fpa, Aa^Fpa, Aa^Fpa, Ms^Xm, Ms^Xm, Ms^Xm, Ms^Xm, Aa^Fpa, Aa^Fpa, Aa^Feta, Aa^Fpa, Aa^Fpa, Aa^Fpa, Ha, Ha^Fpa, Aa^Fpa, Aa^Fpa, Aa^Fpa, Rr, Rp, Aa^Fpa, Ha, Ha, Ha, Aa^Fpa, Aa^Fpa, Ha^Fpa, Aa^Fpa, Ha^Fpa, Ha^Fpa, Ha^Fpa, Ha^Fpa, Ha^Fpa, Ms, Ms, Ms, Ms, Ms
Rb, Rb, Rb, Ha, Ha, Aa^Fpa, Aa^Fpa, Ms^Xm, Aa^Fpa, Ms^Xm, Ms, Ms, Aa^Fpa, Aa^Fpa, Aa^Fpa, Aa^Fpa, Aa^Fpa, Ha, Ha, Aa^Fpa, Rb, Aa^Fpa, Rr, Rp, Rb, Aa^Fpa, Ha^Fpa, Aa^Fpa, Ha^Fpa, Ha^Fpa, Ha^Fpa, Ha^Fpa, Ha^Fpa, Ha^Fpa, Ha^Fpa, Ha^Fpa, Ha^Fpa, Ha^Fpa, Ms, Ms, Ms, Ms
Ms^Xm, Ha, Ha, Rb, Ha, Ha^Fpa, Ha^Fpa, Aa^Fpa, Aa^Fpa, Ms, Ms, Ms, Aa^Fpa, Ha, Rb, Aa^Fpa, Rb, Ha^Vhha, Rb, Rb, Rp, Rb, Rb, Rb, Rb, Aa^Fpa, Ha, Aa^Fpa, Ha^Fpa, Ha^Fpa, Ha^Fpa, Ha^Fpa, Ha^Fpa, Ha^Fpa, Aa^Fpa, Ha^Fpa, Ms, Ms, Ms, Ms, Ms, Ms
Ms^Xm, Ms^Xm, Ms, Ha, Ha, Ha, Ha, Ha, Aa, Aa^Fpa, Aa^Fpa, Aa^Fpa, Rb, Rb, Re, Re, Re, Re, Re, Rp, Rp, Rp, Re, Re, Re^Es, Re^Es, Re^Es, Ha, Ha, Ha, Ms, Ms, Ms, Ha^Fpa, Ms, Ms, Ms, Ms, Ms, Ms, Ms, Ms
Ms^Xm, Ms, Ms, Ms, Ha, Ha, Aa, Aa, Rb, Rb, Rb, Rb, Re, Re^Es, Re, Rd, Re, Re, Rp, Rp^Es, Rp, Rra, Cea, Re, Re, Rd^Dr, Re^Es, Ai, Ha, Ms, Ms, Ms, Ms^Xm, Ms, Ms^Xm, Ms^Xm, Ms^Xm, Ms, Ms, Ms, Ha, Ms
Ms^Xm, Ms, Ms, Ms, Ha, Aa, Rb, Rb^Es, Rb, Rb, Rb, Re, Aa, Re, Ha, Re, Ha, Rb, Ha, Rb, Re^Vct, Cea, Cea^Esa, Cea, Aa^Fpa, Re^Es, Rb, Aa, Ha, Ms, Ms, Ms, Ms^Xm, Ms^Xm, Ms^Xm, Ms^Xm, Ms^Xm, Ms, Ha, Ha, Ha, Ha
Ms^Xm, Ms^Xm, Ms, Ms, Aa^Fpa, Aa, Rb, Rb, Rb^Esa, Rb, Aa^Fpa, Aa^Fpa, Ha, Aa^Fpa, Ha^Fpa, Ha, Ha, Ha, Ha, Ha, Ha, Cea, Cea, Cea^Esa, Aa^Fpa, Rb, Rb, Rb, Ai, Ms, Ms, Ms^Xm, Ms^Xm, Ms^Xm, Ms^Xm, Ms^Xm, Ms, Ha, Ha^Fpa, Ha, Ha, Ha
Ms^Xm, Ms, Ms, Ms, Aa^Fpa, Re, Re^Es, Rb, Ai, Ai, Aa^Fpa, Aa^Fpa, Aa^Fpa, Aa^Fpa, Ha^Fpa, Ha, Ha, Ha, Ms, Ha^Fpa, Ha^Fpa, Ha^Fpa, Ha, Ha, Rb, Rb, Rb, Rb, Ha, Ms, Ms, Ms^Xm, Ms^Xm, Ms^Xm, Ms^Xm, Ms, Ms, Ha^Fpa, Ha^Fpa, Ha^Fpa, Ha^Fpa, Ha
Ms^Xm, Ms^Xm, Ms, Ms, Ms, Re, Rb, Rb, Aa, Ai^Esa, Aa^Fpa, Aa^Fpa, Ha^Fpa, Ha^Fpa, Ha^Fpa, Ha^Fpa, Ms^Xm, Ms, Ms, Ms, Ms, Ha, Ha, Aa^Fpa, Rb, Rb^Es, Rb, Ai, Ms, Ms, Ms, Ms^Xm, Ms, Ms^Xm, Ms, Ms, Ha, Ha^Fpa, Ha^Fpa, Ha^Fpa, Aa^Fpa, Aa^Fpa
Ms^Xm, Ms, Aa^Fpa, Ms, Ha, Aa, Rb^Es, Rb, Rb, Ha, Ha, Aa^Fpa, Ha^Fpa, Ha^Fpa, Ms^Xm, Ms^Xm, Ms^Xm, Ms, Ms, Ms, Ms, Ha, Rb, Rb, Re, Rb, Ms, Ms, Ms, Ms, Ms, Ms, Ms, Ms, Ha, Ha, Ha, Ha, Ha^Fpa, Ha^Fpa, Aa^Fpa, Aa^Fpa
Ms^Fpa, Aa^Fpa, Aa^Fpa, Aa^Fpa, Aa^Fpa, Aa, Rb, Rb, Rb, Re, Ha, Ha^Fpa, Ha, Ha^Fpa, Ms, Ms^Xm, Ms, Ms, Aa, Ms, Aa, Rb, Rp, Re, Re, Aa, Ms, Ms, Ms, Ms, Ms, Ms, Ha, Ha, Ha, Ha, Ha, Ha, Ha^Fpa, Ha^Fpa, Aa^Fpa, Aa^Fpa
Ms^Fpa, Aa^Fpa, Aa^Fpa, Aa^Fpa, Aa^Fpa, Aa, Aa^Fpa, Rb, Rb, Rb, Rb, Ha, Ha, Ms, Ms, Ms, Ms, Aa, Aa, Aa, Rb^Es, Rp, Rb, Rb, Aa^Fpa, Aa^Fpa, Ha^Fpa, Ms, Ha, Ai, Ms, Ha, Ha, Ha, Ha, Ha, Ha, Ha^Fpa, Ha^Fpa, Aa^Fpa, Aa^Fpa, Aa^Fpa
Ms^Fpa, Aa^Fpa, Aa^Fpa, Aa^Fpa, Aa^Fpa, Aa^Fpa, Aa^Fpa, Ha, Rb, Rb^Esa, Rb, Rb, Re, Ms, Ms^Vhha, Ms, Re^Esa, Aa, Rp, Rp, Rb, Rb, Aa, Aa^Fpa, Ha^Fpa, Aa^Fpa, Ha^Fpa, Ha, Ha, Ha, Ha, Ha, Ha^Fpa, Ha^Fpa, Ha^Fpa, Ha^Fpa, Ha^Fpa, Ha^Fpa, Aa^Fpa, Aa^Fpa, Aa^Fpa, Aa^Fpa
Ms^Fpa, Ha, Ha, Aa^Fpa, Aa^Fpa, Aa^Fpa, Aa^Fpa, Aa^Fpa, Ha, Aa, Aa, Rb, Rb, Re, Re, Re, Rb, Rp, Rb, Rb, Aa, Aa^Esa, Ha, Ha, Ha^Fpa, Ha^Fpa, Ha, Ha, Ha, Ha, Ha, Ha, Ha^Fpa, Ha^Fpa, Ha^Fpa, Ha^Fpa, Ha^Fpa, Ha^Fpa, Aa^Fpa, Aa^Fpa, Aa^Fpa, Ha
Ms^Fpa, Ha^Fpa, Ha, Ha, Ha^Fpa, Aa^Fpa, Aa^Fpa, Aa^Fpa, Ha, Ha, Aa, Re, Rb, Rb, Rb^Es, Rb, Rp, Rr, Cay, Re^Vct, Ha, Ha, Ha, Ha^Fpa, Ha^Fpa, Ha, Ha, Ha, Ms^Xm, Ms^Xm, Ms^Xm, Ms^Xm, Ms^Xm, Ms^Xm, Ha^Fpa, Ha^Fpa, Ms^Xm, Aa^Fpa, Aa^Fpa, Aa^Fpa, Ha, Ha
Ms^Xm, Aa^Fpa, Aa^Fpa, Ha, Ha, Ha, Ha, Ha, Ha^Fpa, Ha, Ha, Ha, Ha, Rb, Rb, Rb, Rp, Cay, 5 Kay, Cay, Ha, Ha, Ha, Ha^Fpa, Ha, Ha, Ha, Ms^Xm, Ms^Xm, Ms^Xm, Ms^Xm, Ms^Xm, Ms^Xm, Ms^Xm, Ms^Xm, Ms^Xm, Ms^Xm, Ms^Xm, Ha, Ha, Ha, Ha
Ms^Xm, Aa^Fpa, Aa^Fpa, Ha^Fpa, Ha, Ha, Ms, Ha, Ha, Ha, Ha, Ha, Aa^Fpa, Aa, Rb, Rp, Rp, Cay, Cay, Cay, Ha, Ha, Ha, Ha, Ha, Ha, Ms^Xm, Ms^Xm, Ms^Xm, Ms^Xm, Ms^Xm, Ms^Xm, Ms^Xm, Ms^Xm, Ms^Xm, Ms^Xm, Ms^Xm, Ms^Xm, Ha, Ha, Ha, Ha
Ms^Xm, Ms^Xm, Ha, Ha, Ha, Ha, Ha, Ha, Ha, Ha, Ha^Fpa, Aa^Fpa, Aa^Fpa, Aa^Fpa, Aa, Rb, Rb, Rr, Rp, Rra, Ai, Ha, Ha, Ha, Ha, Ha, Ms^Xm, Ms^Xm, Ms^Xm, Ms^Xm, Ms^Xm, Ms^Xm, Ha^Fpa, Ms^Xm, Ms, Ms, Ms, Ms, Ha, Ha, Aa^Fpa, Aa^Fpa
Ms^Xm, Ms^Xm, Ms^Xm, Ha, Ha^Fpa, Ha^Fpa, Ha^Fpa, Ha, Ha, Ha, Ha^Fpa, Ha^Fpa, Ha^Fpa, Aa^Fpa, Ha, Rb, Rb, Rb, Rb, Rp, Rb, Ha, Ha, Ha, Ha, Ha, Ha, Ha, Ha, Ha, Ha, Ms, Ha^Fpa, Ms, Ha, Ha, Ha, Ms, Ha, Ha, Aa^Fpa, Aa^Fpa
Ha^Fpa, Ms^Xm, Ms^Xm, Ms^Xm, Ha^Fpa, Ha^Fpa, Ha^Fpa, Ha^Fpa, Ha, Ha, Ha, Ha, Ha, Ha, Ha, Ha, Ha, Aa, Cay, Rp, Rb, Ai, Ha, Ha, Ha^Esa, Ha, Ha, Ha, Ha^Fpa, Ha, Ha, Ha^Fpa, Ha^Fpa, Ha^Fpa, Ha, Ha, Ha, Ms, Ha, Aa^Fpa, Aa^Fpa, Aa^Fpa
Ha^Fpa, Ms^Xm, Ha, Ms^Xm, Ms^Xm, Ha^Fpa, Ha^Fpa, Ha^Fpa, Ha^Fpa, Ha, Ha, Ha, Ha^Fpa, Ha, Ha, Ha, Ha, Ha, Rb, Rr, Rb, Rb, Rb, Ha, Ha, Ha, Ha, Ha, Ha^Fpa, Ha^Fpa, Aa^Fpa, Aa^Fpa, Aa^Fpa, Aa^Fpa, Aa^Fpa, Ha, Ha, Ha, Ha, Aa^Fpa, Aa^Fpa, Aa^Fpa
Ha^Fpa, Ha^Fpa, Ha, Ms, Ms, Ms^Xm, Ms^Xm, Ha^Fpa, Ms, Ha^Fpa, Ha, Ha, Ha, Ha, Ha^Esa, Ha, Ha, Ha, Re, Rb, Rb, Rb, Rb, Ai, Ai, Ha, Ha, Ha, Aa^Fpa, Aa^Fpa, Aa^Fpa, Aa^Fpa, Aa^Fpa, Aa^Fpa, Aa^Fpa, Ha, Ha, Ha, Ha, Aa^Fpa, Aa^Fpa, Aa^Fpa
Aa^Fpa, Ha^Fpa, Ha^Fpa, Ha, Ha, Ms, Ms^Xm, Ms^Xm, Ms^Xm, Ms, Ms, Ha, Ha, Ha, Ha, Ha, Ha, Ha, Aa^Fpa, Rb, Rb, Rb^Es, Rb, Rb, Rb, Ai, Aa^Fpa, Aa^Fpa, Aa^Fpa, Aa^Fpa, Aa^Fpa, Aa^Fpa, Aa^Fpa, Aa^Fpa, Ha, Ha, Ha, Ha, Ha, Ha, Aa^Fpa, Aa^Fpa
Aa^Fpa, Aa^Fpa, Aa^Fpa, Ha, Ha, Ms, Ms, Ms^Xm, Ms, Ms^Xm, Ms, Ha, Ha, Ha, Ha, Ha, Aa^Fpa, Aa^Fpa, Aa^Fpa, Aa^Fpa, Aa^Fpa, Rb, Rb, Rb, Rb, Rb, Aa^Fpa, Aa^Fpa, Aa^Fpa, Aa^Fpa, Aa^Fpa, Aa^Fpa, Ha, Ha, Ha, Ha, Ha, Ha, Aa^Fpa, Aa^Fpa, Aa^Fpa, Aa^Fpa
Aa^Fpa, Aa^Fpa, Aa^Fpa, Ha, Ha, Ha, Ha, Ms, Ms, Ms, Ha, Ha, Ha, Ha, Ha^Fpa, Ha, Aa^Fpa, Aa^Fpa, Aa^Fpa, Aa^Fpa, Aa^Fpa, Aa^Fpa, Ai, Rb, Rb, Rb, Rb, Aa^Fpa, Ha, Aa^Fpa, Ha, Ha, Ha, Ha, Ha, Ha, Ha, Ha, Aa^Fpa, Aa^Fpa, Aa^Fpa, Aa^Fpa
Aa^Fpa, Aa^Fpa, Aa^Fpa, Aa^Fpa, Aa^Fpa, Ha, Ha^Fpa, Ha, Ha, Ha, Ha, Ha, Ha, Ha, Ha, Ha^Fpa, Aa^Fpa, Aa^Fpa, Aa^Fpa, Aa^Fpa, Ha^Fpa, Ha^Fpa, Ha, Rb^Esa, Rb, Rb, Rb, Rb, Rb, Ha, Rb, Ha, Ha, Ha, Ha, Ha, Ha, Aa^Fpa, Aa^Fpa, Aa^Fpa, Aa^Fpa, Aa^Fpa
Aa, Aa^Fpa, Aa^Fpa, Aa^Fpa, Aa^Fpa, Aa^Fpa, Aa, Ha, Aa, Ha, Aa^Fpa, Ha^Fpa, Aa^Fpa, Ha, Aa^Fpa, Aa^Fpa, Aa^Fpa, Aa^Fpa, Aa^Fpa, Aa^Fpa, Ha^Fpa, Ha, Ha, Ha, Ha, Rb^Esa, Rb, Rb, Rb, Rb, Rb, Rb, Rb, Rb, Ce, Aa, Aa, Aa^Fpa, Aa^Fpa, Aa^Fpa, Aa^Fpa, Aa
Aa, Aa^Fpa, Aa^Fpa, Aa^Fpa, Aa^Fpa, Aa^Fpa, Aa, Aa, Aa, Aa, Aa, Aa^Fpa, Aa^Fpa, Aa, Aa^Fpa, Aa^Fpa, Aa^Fpa, Aa^Fpa, Aa^Fpa, Aa^Fpa, Aa^Fpa, Ha^Fpa, Ai, Ha, Aa, Aa, Rb, Rb, Rb, Rb, Rb, Rb, Rb, Rb, Ce, Ce, Aa, Aa^Fpa, Aa^Fpa, Aa^Fpa, Aa, Aa
Aa, Aa, Aa, Aa^Fpa, Aa^Fpa, Aa^Fpa, Aa, Aa^Fpa, Aa, 3 Aa, Aa, Aa, Aa, Aa, Aa^Fpa, Aa^Fpa, Aa^Fpa, Aa^Fpa, Aa^Fpa, Aa^Fpa, Aa^Fpa, Aa^Fpa, Aa^Fpa, Aa, Aa, Aa, Ai, Rb, Rb, Rb, Re^Vct, Rb, Ce, Ce, 1 Ke, Ce, Rb, Aa, Aa, Aa, Aa, Aa
Aa, Aa, Aa, Aa, Aa, Aa, Aa, Aa, Aa, Aa, Aa, Aa, Aa, Aa, Aa^Fpa, Aa^Fpa, Aa^Fpa, Aa^Fpa, Aa^Fpa, Aa^Fpa, Aa^Fpa, Aa^Fpa, Aa^Fpa, Aa^Fpa, Ai, Ai, Ai, Aa, Aa, Aa, Aa, Aa, Aa, Rb, Rb, Rb, Rb, Aa, Aa, Aa, Aa, Aa
