border_size=1
usage=map

Spay, Spay, Spay, Aa, Aa, Aa, Aa, Aa^Fpa, Aa^Fpa, Aa^Fpa, Aa^Fpa, Aa^Fpa, Ha, Aa^Fpa, Ms, Ha, Ms, Ms, Ha, Ha^Fpa, Ha^Fpa, Ha, Ms, Ms, Ms, Ms, Ms, Ms, Ms, Ms, Ms^Xm, Ms^Xm, Ms^Xm, Ms, Ms^Xm, Ms^Xm, Ms^Xm, Ms, Ms, Ms, Ms, Ms, Ms, Ms, Ms, Ha, Ms, Ms, Ms
Aa, Spay, Spay, Spay, Aa, Aa, Aa, Aa, Aa^Fpa, Aa^Fpa, Aa^Fpa, Aa^Fpa, Ha, Ms, Ms, Ms, Ha, Ha, Ha^Fpa, Ha^Fpa, Aa^Fpa, Ha^Fpa, Ha^Fpa, Ha, Ha, Ms, Ha, Ms, Ms, Ms, Ms, Ms^Xm, Ms, Ms^Xm, Ms, Ms, Ms, Ms, Ms, Ms, Ms, Ms, Ms, Ms, Ms, Ms, Ms, Ms, Ha
Aa, Spay, Spay, Spay, Spay, Aa, Aa, Aa, Aa^Fpa, Aa^Fpa, Aa^Fpa, Aa^Fpa, Aa^Fpa, Ha, Ha, Ha, Aa, Aa^Fpa, Aa^Fpa, Ha^Fpa, Aa^Fpa, Aa^Fpa, Aa^Fpa, Aa^Fpa, Ha^Fpa, Ha, Ha, Ha, Ms, Ms, Ms, Ms, Ms, Ms^Xm, Ms, Ms, Ms, Ms, Ms, Ms, Ms, Ms, Ms, Ms, Ms, Ha, Ha, Ha, Aa
Aa, Aa, Aa, Spay, Spay, Spay, Spay, Aa, Aa, Aa^Fpa, Aa, Aa^Fpa, Aa^Fpa, Ha^Fpa, Ha, Aa, Aa, Aa, Aa, Aa^Fpa, Aa, Aa, Aa, Aa^Fpa, Aa, Ha, Ms, Ms, Ms, Ms, Ha, Ms, Ms, Ms, Ms, Ms, Ms, Ms, Ms, Ha, Ha^Fpa, Ha, Ms, Ha, Aa^Fpa, Aa, Aa, Aa^Fpa, Aa
Aa^Fpa, Aa, Aa, Aa, Aa, Spay, Spay, Aa, Aa, Aa, Aa, Aa, Aa, Aa, Aa, Aa, Rb, Rb, Rb, Rb, Rb, Aa, Aa, Aa, Aa, Aa, Aa, Aa, Aa, Ha, Ha^Fpa, Ha, Ha, Ha, Ms, Ha, Ms, Ms, Ms, Ha^Fpa, Ha^Fpa, Ha^Fpa, Aa^Fpa, Aa^Fpa, Aa^Fpa, Aa, Aa, Aa, Spay
Aa^Fpa, Aa^Fpa, Aa, Aa, Aa, Spay, Spay, Spay, Spay, Aa^Voa, Spay, Aa, Aa, Aa, Rb, Aa, Rb, Re^Vct, Uu, Gll^Fp, Uu, Rb, Aa, Aa^Fyak, Aa, Aa, Spay, Aa, Aa, Aa, Aa^Fpa, Ha^Fpa, Ha, Ha, Ha^Fpa, Ha^Fpa, Ha^Fpa, Ha, Ha^Fpa, Ha^Fpa, Aa^Fpa, Aa^Fpa, Ha, Ha^Fpa, Aa^Fpa, Aa, 1 Spay, Spay, Spay
Aa^Fpa, Aa^Fpa, Aa, Aa, Aa, Aa, Aa, Spay, Spay, Spay, Spay, Spay, Spay, Spay, Spay, Rb, Uu, Uu, Ql, Uu, Gs, Rb, Rb, Aa, Rb, Spay, Rb, Rb, Rb, Aa, Aa, Aa, Aa, Aa, Aa^Fpa, Ha^Fpa, Ha^Fpa, Ha^Fpa, Aa^Fpa, Aa^Fpa, Aa^Voa, Aa, Ha, Aa, Spay, Spay, Spay, Spay, Aa
Aa^Fpa, Aa^Fpa, Aa^Fpa, Aa^Fpa, Aa^Fpa, Aa, Aa, Aa, Aa, Spay, Aa, Spay, Spay, Spay, Rb, Rb, Gll^Fp, Uu, Uu, Uu, Gll^Fp, Re^Vct, Rb^Ecf, Rb, Rb, Rb, Rb, Rb, Rb, Rb, Spay, Spay, Spay, Aa, Aa, Aa^Fpa, Aa, Aa^Fpa, Aa^Fpa, Aa^Fpa, Aa, Aa, Aa, Aa^Fpa, Spay, Spay, Aa, Aa, Aa
Aa^Fpa, Aa^Fpa, Aa^Fpa, Aa^Fpa, Aa^Fpa, Aa^Fpa, Aa, Aa, Aa, Aa, Aa, Aa, Aa, Aa, Aa, Rb, Rb, Gs, Rb, Gll^Fp, Rb, Rb, Rb, Rb, Aa, Rb, Aa, Rb, Aa, Spay, Spay, Spay, Spay, Spay, Spay, Aa, Spay, Aa, Aa, Aa, Spay, Spay, Spay, Spay, Spay, Spay, Ha, Ha, Ms^Xm
Aa^Fpa, Aa^Fpa, Aa^Fpa, Aa^Fpa, Aa^Fpa, Aa^Fpa, Aa, Aa, Aa, Aa, Aa, Aa, Ha, Aa, Aa, Aa, Aa^Fpa, Rb, Rb, Rb, Aa, Rb, Aa, Aa, Aa, Aa, Aa, Aa, Aa, Aa, Aa, Aa, Aa, Spay, Spay, Spay, Spay, Spay, Spay, Spay, Spay, Spay, Aa, Spay, Aa, Aa^Fpa, Ha, Ms^Xm, Ms^Xm
Aa^Fpa, Aa^Fpa, Aa^Fpa, Aa^Fpa, Aa, Aa, Aa, Aa, Aa, Aa, Aa^Fpa, Ha^Fpa, Aa, Aa, Aa, Aa, Spay, Re, Aa^Fpa, Aa^Fpa, Aa^Fpa, Aa, Aa, Aa, Ha, Aa, Ha, Ha, Ha, Ha, Aa, Aa, Aa^Fpa, Aa, Aa, Spay, Aa, Spay, Spay, Spay, Aa, Aa, Aa^Fpa, Aa, Ha, Ha, Ms, Ms^Xm, Ms^Xm
Aa^Fpa, Aa^Fpa, Aa^Fpa, Aa, Aa, Aa, Aa, Aa, Aa^Fyak, Aa, Aa^Fpa, Aa^Fpa, Aa^Fpa, Aa^Fpa, Aa, Spay, Spay^Voa, Spay, Aa, Aa^Fpa, Ha^Fpa, Aa, Aa, Ha, Ha, Ha, Ha, Ha, Ms, Ms, Ha, Ha^Fpa, Aa^Fpa, Aa^Fpa, Aa^Fpa, Aa^Fpa, Aa^Fpa, Aa, Aa, Aa, Ha, Ha^Fpa, Ha, Ha, Ha, Ha, Ms, Ms^Xm, Ms^Xm
Aa^Fpa, Aa^Fpa, Aa^Fpa, Aa, Ha, Aa, Aa^Fpa, Aa^Fpa, Aa^Fpa, Aa^Fpa, Aa, Ha, Ha^Fpa, Aa^Fpa, Aa, Spay, Spay, Spay, Aa, Ha^Fpa, Ha, Ha, Ha, Aa, Ha, Ha, Ms^Xm, Ms, Ms^Xm, Ms^Xm, Ms^Xm, Ha^Fpa, Ha^Fpa, Aa^Fpa, Aa^Fpa, Aa^Fpa, Ha^Fpa, Ha^Fpa, Ha, Ha, Ha, Ha, Ha, Ms, Ms^Xm, Ha, Ms, Ms^Xm, Ms^Xm
Aa^Fpa, Aa^Fpa, Aa, Aa, Ha, Ha^Fpa, Ha^Fpa, Aa^Fpa, Aa, Aa^Fpa, Aa, Aa, Aa, Aa, Aa, Aa, Spay, Spay, Spay, Aa, Aa, Ha, Ha^Fpa, Aa, Ha, Ha, Ha, Ms, Ms, Ms^Xm, Ms^Xm, Ha^Fpa, Aa^Fpa, Aa^Fpa, Aa^Fpa, Ha^Fpa, Ha^Fpa, Ha^Fpa, Ha, Ms, Ms^Xm, Ms, Ms^Xm, Ms^Xm, Ms, Ms^Xm, Ms^Xm, Ms^Xm, Ms
Aa, Aa, Aa, Aa, Aa, Ha, Aa, Aa, Aa, Aa, Aa, Aa, Aa, Aa, Aa, Aa, Aa^Fpa, Spay, Spay, Aa, Aa, Aa^Fpa, Aa^Fpa, Aa, Aa, Ha, Ha, Ms, Ms, Ms, Ha, Aa^Fpa, Aa^Fpa, Aa^Fpa, Ha^Fpa, Ha^Fpa, Ms, Ms, Ms^Xm, Ms^Xm, Ms, Ms^Xm, Ms, Ms, Ms, Ms^Xm, Ha, Ms, Ms
Aa, Aa, Aa, Aa, Aa, Aa, Aa, Aa, Aa^Fpa, Aa^Fpa, Aa^Fpa, Aa, Aa, Aa^Fpa, Aa, Aa, Coa, Spay, Spay, Aa^Fpa, Coa, Aa^Fpa, Aa^Fpa, Aa, Aa, Aa, Aa, Ha, Ha^Fpa, Ha, Aa, Aa, Aa, Aa, Ha, Ms, Ms, Ms^Xm, Ms, Ms, Ms, Ms, Ms, Ms, Ms, Ha, Ha^Fpa, Ha, Ms
Aa, Aa, Aa, Aa, Aa, Aa, Aa, Aa^Fpa, Tyb, Aa^Fpa, Aa^Fpa, Aa, Aa, Aa, Aa, Aa^Fpa, Aa^Fpa, Spay, Spay, Aa^Fpa, Aa, Aa^Fpa, Aa^Fpa, Aa^Fpa, Aa, Aa, Aa, Aa^Fpa, Aa^Fpa, Aa^Fpa, Aa, Aa, Aa, Aa, Aa^Fpa, Ha^Fpa, Ha^Fpa, Ms, Ms, Ms, Ha, Ha, Ha, Ha, Ha, Ha^Fpa, Ha^Fpa, Ha^Fpa, Ha
Tyb, Tyb, Tyb, Aa, Aa, Aa, Aa, Aa^Fpa, Tyb, Aa^Fpa, Aa^Fpa, Aa, Aa, Aa, Aa, Aa^Fpa, Spay, Spay, Aa, Aa, Aa, Aa, Tyb, Aa^Fpa, Tyb, Aa, Aa^Fpa, Aa, Aa, Aa, Aa, Aa, Aa, Aa, Aa^Fpa, Ha^Fpa, Ha^Fpa, Ha^Fpa, Ha, Ha, Ha, Ha, Aa^Fpa, Ha^Fpa, Aa^Fpa, Ha^Fpa, Aa^Fpa, Ha^Fpa, Ha^Fpa
Tyb, Tyb, Tyb, Aa, Aa, Aa, Aa, Aa^Fpa, Aa^Fpa, Tyb, Aa, Aa, Aa, Aa, Aa, Aa, Spay, Spay, Aa^Fpa, Aa, Aa, Aa, Tyb, Tyb, Tyb, Tyb, Tyb, Aa^Fpa, Aa, Aa, Aa, Aa, Aa, Aa, Aa, Aa^Fpa, Aa^Fpa, Aa^Fpa, Aa, Ha, Aa, Aa, Aa, Aa^Fpa, Aa, Aa, Aa^Fpa, Aa^Fpa, Ha^Fpa
Tyb, Tyb, Tyb, Tyb, Aa, Aa, Aa, Aa, Aa, Tyb, Tyb, Aa, Tyb, Aa, Aa, Aa, Spay, Spay, Spay, Spay, Spay, Aa^Fpa, Aa^Fpa, Tyb, Aa, Tyb, Tyb, Tyb, Aa, Aa, Aa, Aa, Aa, Aa, Aa, Aa, Aa, Aa, Aa, Aa, Aa, Aa, Aa, Aa, Aa, Aa, Aa, Aa^Fpa, Aa
Ai, Ai, Ai, Tyb, Aa, Aa, Aa, Aa, Aa^Fpa, Aa^Fpa, Ai, Tyb, Tyb, Aa^Fpa, Aa^Fpa, Aa, Aa, Spay, Spay, Spay, Spay, Spay, Aa^Fpa, Tyb, Aa, Aa^Fpa, Aa^Fpa, Aa^Fpa, Aa^Fpa, Aa, Aa, Aa, Aa, Aa, Aa, Aa^Fpa, Aa^Fpa, Aa, Aa, Aa, Aa, Aa, Aa, Aa, Aa, Aa, Aa, Aa, Aa
Aa, Ai, Ai, Ai, Aa, Aa, Aa, Aa, Ai, Ai, Ai, Ai, Ai, Aa^Fpa, Aa^Fpa, Aa, Aa, Aa, Aa, Aa^Voa, Spay, Spay, Aa^Fpa, Aa^Fpa, Aa, Aa, Aa, Aa^Fpa, Aa, Aa, Aa, Aa, Aa, Aa, Aa, Aa^Fpa, Tyb, Aa, Aa, Aa, Aa, Aa^Fpa, Aa, Aa, Aa, Aa, Aa, Aa, Aa
Aa^Fpa, Aa, Aa, Aa, Aa, Aa, Aa, Aa, Ai, Ai, Ai, Ai, Ai, Aa^Fpa, Aa, Aa, Aa, Aa, Aa, Aa, Spay, Spay, Aa, Aa, Aa, Aa, Aa, Aa, Aa, Aa, Aa, Aa, Aa, Aa, Aa, Aa^Fpa, Aa, Tyb, Aa^Fpa, Aa, Aa, Aa, Aa, Aa, Aa, Aa, Aa, Aa, Aa
Aa^Fpa, Aa^Fpa, Aa^Fpa, Aa, Aa, Aa, Aa^Fpa, Aa^Fpa, Tyb, Ai, Tyb, Ai, Ai, Ai, Ai, Aa^Fpa, Ai, Aa, Aa, Aa, Spay, Spay, Aa, Aa, Aa, Aa, Aa^Fpa, Aa^Fpa, Aa^Fpa, Aa, Aa, Aa, Aa, Aa, Aa, Aa, Aa, Aa, Aa, Aa, Aa, Aa, Aa, Aa, Aa, Aa, Aa, Aa, Aa
Aa^Fpa, Aa^Fpa, Aa^Fpa, Aa^Fpa, Aa, Aa, Aa, Tyb, Tyb, Tyb, Tyb, Tyb, Tyb, Ai, Ai, Ai, Ai, Aa^Fpa, Aa, Aa, Spay, Spay, Aa, Aa, Aa, Aa^Fpa, Tyb, Tyb, Tyb, Aa^Fpa, Tyb, Aa, Aa, Aa, Aa, Aa, Aa, Aa, Aa, Aa, Aa, Aa, Aa, Aa, Aa, Aa, Aa, Aa, Aa
Aa^Fpa, Aa^Fpa, Aa^Fpa, Aa^Fpa, Aa, Aa, Aa, Aa, Aa, Tyb, Tyb, Tyb, Tyb, Tyb, Tyb, Ai, Ai, Ai, Ai, Aa, Spay, Spay, Aa, Aa, Aa, Aa, Aa, Tyb, Tyb, Tyb, Aa, Tyb, Tyb, Tyb, Tyb, Aa^Fpa, Aa^Fpa, Aa^Fpa, Aa, Aa, Aa, Aa, Aa, Aa, Aa, Aa, Aa, Aa, Aa
