border_size=1
usage=map

Ha          , Ha          , Ha          , Ha          , Ms          , Ms          , Ms          , Ms          , Aa          , Rb          , Aa          , Ms          , Ms          , Ms          , Ms          , Ms          , Ms          , Ms          , Ms          , Ms          , Ms          , Ms          , Ms          , Ms          , Ms          , Ms          , Mm^Xm       , Mm^Xm       , Mm^Xm       , Mm^Xm       , Mm^Xm       , Mm^Xm       , Mm^Xm       , Mm^Xm       , Mm^Xm       , Mm^Xm       , Mm^Xm       
Ms          , Ha          , Ha          , Ha          , Ha          , Ms          , Ms          , Ms          , Aa          , Rb          , Rb          , Aa          , Aa          , Ms          , Ha^Fpa      , Ha^Fpa      , Aa          , Ms          , Aa          , Aa          , Aa          , Ms          , Ha          , Ms          , Ha          , Ms          , Ms          , Mm^Xm       , Ms          , Ms          , Mm^Xm       , Mm^Xm       , Mm^Xm       , Mm^Xm       , Mm^Xm       , Mm^Xm       , Mm^Xm       
Ms          , Ms          , Ms          , Ms          , Ms          , Ha          , Ha          , Aa          , Ha          , Aa          , Aa          , Rb          , Rb          , Rb          , Rb          , Aa          , Rb          , Aa          , Aa          , Aa          , Aa          , Aa          , Aa          , Aa          , Aa          , Ha          , Ha          , Ms          , Ms          , Ms          , Ms          , Mm^Xm       , Ms          , Mm^Xm       , Mm^Xm       , Mm^Xm       , Mm^Xm       
Mm^Xm       , Ms          , Ms          , Ms          , Ms          , Ms          , Ms          , Ha          , Ha          , Ha          , Ha^Fpa      , Aa          , Aa          , Aa          , Aa          , Rb          , Aa          , Rb          , Rb          , Aa          , Aa          , Aa          , Aa          , Aa          , Aa^Fpa      , Ha^Fpa      , Ha^Fpa      , Ha          , Ha          , Ms          , Ms          , Ms          , Ms          , Mm^Xm       , Ms          , Mm^Xm       , Mm^Xm       
Mm^Xm       , Mm^Xm       , Mm^Xm       , Mm^Xm       , Mm^Xm       , Ms          , Ms          , Ha          , Ha          , Ha          , Ha          , Ha          , Ha          , Aa          , Ha          , Aa          , Ha          , Aa          , Aa          , Rb          , Rb          , Aa          , Aa          , Aa          , Aa          , Ha^Fpa      , Ha^Fpa      , Ha^Fpa      , Ha^Fpa      , Ha          , Ha          , Ms          , Ms          , Ms          , Ms          , Mm^Xm       , Mm^Xm       
Ms          , Mm^Xm       , Mm^Xm       , Mm^Xm       , Mm^Xm       , Mm^Xm       , Mm^Xm       , Ms          , Ms          , Ha          , Ms          , Ms          , Ms          , Ms          , Ms          , Ha          , Ha          , Aa          , Aa          , Rb          , Rb          , Aa          , Aa          , Aa          , Aa          , Ha^Fpa      , Ha^Fpa      , Ha^Fpa      , Aa          , Ha          , Ha          , Ms          , Ms          , Ms          , Ms          , Mm^Xm       , Mm^Xm       
Ms          , Ms          , Ms          , Mm^Xm       , Mm^Xm       , Mm^Xm       , Ms          , Mm^Xm       , Ms          , Ms          , Ha          , Ha          , Ha          , Ha          , Ha          , Ha          , Aa          , Aa          , Rb          , Rb          , Aa^Fpa      , Aa          , Coa         , Aa          , Aa          , Aa          , Aa          , Aa          , Ha          , Aa          , Ai          , Ha          , Ha          , Ms          , Ms          , Ms          , Ms          
Ms          , Ms          , Ms          , Ms          , Ms          , Ms          , Ms          , Ms          , Ha          , Ha          , Ha          , Ha          , Aa          , Ha          , Aa          , Aa          , Rb          , Rb          , Aa          , Rb          , Rb          , Aa          , Rb          , Koa         , Coa         , Aa          , Aa          , Aa          , Ha^Fpa      , Ha          , Ha          , Ai          , Ai          , Ha          , Ha          , Ms          , Ms          
Ms          , Ms          , Ms          , Ms          , Ms          , Ms          , Ha          , Ha          , Ha          , Ha          , Aa          , Aa          , Aa          , Aa          , Rb          , Rb          , Aa          , Aa          , Aa          , Rb          , Rb          , Rb          , Aa          , Coa         , Aa          , Aa          , Aa          , Aa          , Aa          , Ha^Fpa      , Ha          , Ai          , Ai          , Ha          , Ha          , Ms          , Ms          
Ms          , Ms          , Ha          , Ha          , Ha          , Ha          , Ha          , Ha          , Aa          , Aa          , Aa          , Aa          , Rb          , Rb          , Aa          , Aa          , Aa          , Aa          , Aa          , Aa^Voa      , Aa          , Rb          , Aa          , Aa          , Aa          , Aa          , Aa          , Aa          , Aa          , Ha          , Ha          , Ha          , Ha          , Ha          , Ha          , Ms          , Ms          
Ms          , Ha          , Ha          , Ha          , Aa          , Ha          , Aa          , Aa          , Aa          , Aa          , Aa          , Rb          , Aa          , Aa          , Aa          , Aa          , Aa^Fpa      , Aa          , Aa          , Aa          , Aa          , Rb          , Aa          , Aa          , Ha          , Ha          , Ha^Fpa      , Aa          , Aa          , Aa          , Ha          , Ha          , Ms          , Ha          , Ha          , Ms          , Ms          
Ms          , Ha          , Ha          , Aa          , Aa          , Aa          , Aa          , Aa          , Aa          , Aa          , Aa          , Rb          , Rb          , Aa          , Aa          , Aa          , Aa          , Aa          , Aa          , Aa          , Aa          , Rb          , Aa          , Aa          , Ha^Fpa      , Ms          , Ha          , Aa^Fpa      , Aa^Fpa      , Aa          , Ha^Fpa      , Ha          , Ms          , Ms          , Ms          , Ms          , Ms          
Ms          , Ms          , Ha          , Aa          , Aa          , Aa          , Aa          , Aa          , Aa          , Aa          , Aa          , Aa          , Rb          , Aa          , Aa^Fpa      , Aa          , Aa          , Aa          , Aa          , Aa^Fpa      , Aa          , Rb          , Aa          , Aa^Fpa      , Aa^Fpa      , Ha          , Aa          , Aa          , Aa^Fpa      , Aa^Fpa      , Ha^Fpa      , Ha          , Ha          , Ms          , Ms          , Ms          , Ms          
Ms          , Ms          , Ha          , Ha          , Ha          , Aa          , Ha          , Aa          , Aa          , Aa          , Rb          , Rb          , Aa          , Rb          , Aa^Fpa      , Aa^Fpa      , Aa^Fpa      , Aa          , Aa          , Aa          , Aa          , Rb          , Rb          , Aa          , Aa          , Aa          , Aa          , Aa          , Aa^Fpa      , Aa^Fpa      , Ha^Fpa      , Ha^Fpa      , Ha          , Ms          , Ms          , Ms          , Ms          
Ms          , Ms          , Ha          , Ha          , Ha          , Ha          , Aa          , Aa          , Aa          , Rb          , Aa          , Aa          , Aa          , Aa          , Aa          , Aa^Fpa      , Ms          , Ms          , Ha          , Aa          , Aa          , Aa          , Aa^Voa      , Rb          , Aa          , Aa          , Aa          , Aa          , Aa          , Aa^Fpa      , Aa^Fpa      , Ha^Fpa      , Ha^Fpa      , Ha          , Ha          , Ms          , Ms          
Ms          , Ms          , Ha          , Ha          , Ha          , Aa          , Aa          , Aa          , Rb          , Rb          , Aa          , Aa          , Aa          , Aa          , Ha          , Ms          , Ms          , Ms          , Ha          , Aa          , Aa          , Aa          , Aa          , Re          , Rd          , Aa          , Aa          , Aa          , Aa          , Aa          , Aa          , Aa          , Ha^Fpa      , Ha          , Ha          , Ms          , Ms          
Ms          , Ms          , Ms          , Ha          , Ha          , Aa          , Aa          , Aa          , Rb          , Aa          , Aa          , Aa          , Rb          , Ha          , Ha          , Ha          , Ms          , Ms          , Ha          , Aa          , Aa          , Aa          , Aa          , Re          , Aa          , Aa^Voa      , Rb          , Aa          , Aa          , Aa          , Aa          , Aa          , Aa          , Ha^Fpa      , Ha          , Ms          , Ms          
Ms          , Ms          , Ms          , Ha          , Ha          , Aa          , Aa          , Aa          , Aa          , Rb          , Rb          , Aa          , Aa          , Rb          , Coa         , Ha          , Ha          , Ha          , Ha          , Ha          , Ha          , Aa          , Aa          , Re          , Aa          , Aa          , Rb          , Aa          , Aa          , Aa          , Aa          , Aa          , Aa          , Aa          , Aa          , Ha          , Ha          
Ms          , Ms          , Ms          , Ms          , Ms          , Ha          , Ha          , Aa          , Aa          , Aa          , Aa          , Rb          , Rb          , Aa          , Coa         , 2 Koa       , Coa         , Ha          , Ha          , Ha          , Aa          , Aa          , Aa          , Rb          , Rb          , Rb          , Aa          , Aa          , Aa          , Aa          , Aa          , Aa          , Aa          , Aa          , Aa          , Ha          , Ha          
Ms          , Ms          , Ha          , Ms          , Ha          , Ms          , Ha          , Ha          , Aa          , Aa          , Aa^Voa      , Aa          , Re          , Rb          , Re          , Coa         , Rb          , Aa          , Aa          , Aa          , Aa          , Aa          , Rb          , Rb          , Aa          , Aa          , Ha          , Ha          , Ms          , Ha          , Aa          , Aa          , Aa          , Aa          , Aa          , Aa^Fpa      , Aa^Fpa      
Ms          , Ms          , Ha          , Ha          , Aa          , Ha          , Ha          , Aa          , Aa          , Aa          , Aa          , Aa          , Coa         , Re          , Aa          , Aa          , Rb          , Re          , Coa         , Aa          , Rb          , Rb          , Aa          , Aa          , Aa          , Ha          , Ha          , Ms          , Ha          , Aa          , Aa          , Aa          , Aa          , Aa          , Aa          , Aa^Fpa      , Aa^Fpa      
Ms          , Ms          , Ha          , Ha          , Aa          , Aa          , Aa          , Aa          , Aa          , Aa          , Aa          , Aa          , Rb          , Re          , Aa          , Aa          , Aa          , Rb          , Rb          , Rb          , Aa          , Aa          , Aa          , Aa          , Aa          , Aa          , Aa          , Ha          , Aa          , Aa          , Aa          , Aa          , Aa          , Aa          , Ha          , Ha          , Ha          
Ms          , Ms          , Ha          , Ha          , Aa          , Aa          , Aa^Fpa      , Aa          , Aa          , Aa          , Aa          , Aa          , Aa          , Aa          , Aa          , Aa          , Rb          , Rb          , Aa          , Aa          , Aa          , Aa          , Aa          , Aa          , Aa          , Aa          , Aa          , Aa          , Aa          , Aa          , Aa          , Ha          , Ha          , Ha          , Ha          , Ha          , Ha          
Ms          , Ha          , Ha          , Ha          , Aa          , Aa^Fpa      , Aa^Fpa      , Aa^Fpa      , Aa          , Aa          , Aa          , Aa          , Aa^Fpa      , Aa          , Aa          , Rb          , Rb          , Aa          , Aa^Voa      , Aa          , Coa         , Aa          , Re          , Aa          , Aa^Fpa      , Aa          , Aa^Fpa      , Aa          , Aa          , Aa          , Ha          , Ha          , Ms          , Ha          , Ha          , Ha          , Ha          
Ms          , Ha          , Ha          , Ha          , Aa          , Aa          , Aa          , Aa          , Aa          , Aa          , Aa          , Aa          , Aa          , Aa          , Rb          , Rb          , Gg          , Aa          , Aa          , Aa          , Re          , Re          , Uh          , Re          , Gs^Fp       , Aa^Fpa      , Aa^Fpa      , Aa          , Aa          , Ha          , Ha^Fpa      , Ms          , Ms          , Ms          , Ha^Fpa      , Ha          , Ha          
Ms          , Ms          , Ha          , Ha          , Aa          , Aa          , Aa          , Aa          , Aa          , Aa          , Rb          , Rb          , Rb          , Rb          , Rb          , Rb          , Rb          , Re          , Re          , Re          , Uu          , Uu          , Uu          , Gg^Vo       , Gs^Fp       , Aa^Fpa      , Aa^Fpa      , Aa^Fpa      , Aa          , Aa          , Ha^Fpa      , Ms          , Ms          , Ms          , Ha^Fpa      , Ha          , Ha          
Ms          , Ms          , Ha          , Ha          , Aa          , Aa          , Aa          , Aa          , Aa          , Aa          , Aa          , Aa^Fpa      , Aa          , Re^Vct      , Gs^Fdw      , Re^Vct      , Gs^Fdw      , Gs^Fdw      , Re          , Uh          , Uu          , Ql          , Uu          , Re          , Re          , Aa^Fpa      , Aa^Fpa      , Aa^Fpa      , Aa          , Aa          , Aa^Fpa      , Ha^Fpa      , Ha^Fpa      , Ha^Fpa      , Ha^Fpa      , Ha          , Ha          
Ms          , Ms          , Ha          , Ha          , Aa          , Aa          , Aa          , Aa          , Aa          , Aa          , Ce          , Aa          , Ce          , Ce          , Ce          , Re^Vct      , Re          , Re          , Re          , Re          , Uh          , Uu          , Uh          , Uh          , Re          , Aa^Fpa      , Aa^Fpa      , Aa^Fpa      , Aa          , Aa          , Aa          , Aa^Fpa      , Aa^Fpa      , Ha^Fpa      , Ha          , Ha          , Ha          
Ms          , Ms          , Ha          , Aa          , Aa          , Aa          , Aa^Fpa      , Aa          , Aa          , Aa          , Rd          , Ce          , Ce          , 1 Ke        , Re          , Re          , Ww          , Re          , Re^Vct      , Re          , Re          , Uh          , Re          , Re          , Aa^Fpa      , Aa^Fpa      , Aa^Fpa      , Aa          , Aa          , Aa          , Aa          , Aa^Fpa      , Aa          , Aa          , Aa          , Ha          , Ha          
Ms          , Ms          , Ha          , Aa          , Aa^Fpa      , Aa          , Aa^Fpa      , Aa          , Aa          , Aa          , Aa          , Re^Vct      , Gs          , Re          , Ww          , Ww          , Ww          , Ww          , Ai          , Re          , Aa          , Re          , Aa          , Aa          , Aa^Fpa      , Aa^Fpa      , Aa          , Aa          , Aa          , Aa          , Aa          , Aa          , Aa          , Aa          , Ha^Fpa      , Ha          , Ha          
Ms          , Ms          , Ha^Fpa      , Aa          , Aa          , Aa^Fpa      , Aa^Fpa      , Aa          , Aa          , Aa          , Aa          , Aa          , Gs          , Gs          , Re          , Re          , Ai          , Ai          , Ai          , Aa^Fpa      , Aa          , Aa          , Aa          , Aa^Fpa      , Aa          , Aa          , Aa          , Aa          , Aa          , Dyb         , Aa          , Aa          , Aa          , Ha^Fpa      , Ha^Fpa      , Ha          , Ha          
Ms          , Ms          , Ha^Fpa      , Aa          , Aa          , Aa          , Aa          , Aa^Fpa      , Aa^Fpa      , Aa          , Aa          , Aa          , Aa          , Aa          , Re          , Re          , Aa          , Ai          , Aa          , Aa          , Aa          , Aa          , Aa          , Aa          , Aa          , Aa          , Aa          , Aa          , Aa          , Aa          , Aa          , Aa          , Ha^Fpa      , Aa          , Ha          , Ha          , Ha          
Ms          , Ms          , Ha^Fpa      , Ha^Fpa      , Aa^Fpa      , Aa          , Aa^Fpa      , Aa^Fpa      , Aa^Fpa      , Rb          , Rb          , Aa          , Re          , Aa          , Re          , Rb          , Re          , Aa          , Aa          , Aa          , Aa          , Aa          , Aa          , Aa          , Aa          , Aa          , Aa          , Aa          , Aa          , Aa          , Ha^Fpa      , Ha^Fpa      , Ha^Fpa      , Ha^Fpa      , Ha          , Ha          , Ha          
Ms          , Ha^Fpa      , Ha^Fpa      , Ha^Fpa      , Aa^Fpa      , Aa^Fpa      , Aa^Fpa      , Aa^Fpa      , Aa^Fpa      , Rb          , Rb          , Re          , Re          , Re          , Re          , Re          , Aa          , Aa          , Aa          , Aa          , Aa          , Aa          , Aa          , Aa          , Aa          , Ha          , Aa          , Aa          , Aa          , Aa          , Ha          , Ha^Fpa      , Ha^Fpa      , Ha          , Ha          , Ha          , Ha          
Ms          , Ha^Fpa      , Ha^Fpa      , Ha^Fpa      , Aa^Fpa      , Aa^Fpa      , Aa^Fpa      , Aa^Fpa      , Aa          , Aa^Fpa      , Rb          , Re          , Coa         , Aa          , Aa          , Aa          , Rb          , Aa          , Aa          , Aa          , Aa          , Aa          , Aa          , Aa          , Aa          , Aa          , Aa          , Aa          , Aa          , Aa          , Aa          , Ha          , Aa          , Ha          , Aa          , Ha          , Ha          
Ms          , Ms          , Ms          , Ha^Fpa      , Aa^Fpa      , Aa^Fpa      , Aa^Fpa      , Aa^Fpa      , Aa          , Aa          , Aa          , Aa          , Rb          , Aa          , Rb          , Rb          , Ha          , Rb          , Ha          , Aa          , Ha          , Ha          , Ha          , Ha          , Aa          , Aa          , Aa          , Aa          , Aa          , Dyb         , Aa          , Aa          , Dyb         , Aa          , Aa          , Ha          , Ha          
Ms          , Ms          , Ha^Fpa      , Ha^Fpa      , Aa^Fpa      , Aa^Fpa      , Aa^Fpa      , Aa          , Aa          , Rb          , Rb          , Rb          , Rb          , Rb          , Aa          , Ha          , Ha          , Ha          , Aa          , Ha          , Ha          , Ha          , Ha          , Aa          , Aa          , Aa          , Aa          , Aa          , Dyb         , Aa          , Aa          , Aa          , Aa          , Aa          , Aa          , Ha          , Ha          
Ms          , Ms          , Ha^Fpa      , Ha^Fpa      , Aa^Fpa      , Aa^Fpa      , Aa^Fpa      , Aa          , Aa          , Aa          , Rb          , Rb          , Aa          , Aa          , Aa          , Aa          , Aa          , Aa          , Aa          , Aa          , Aa          , Ha          , Aa          , Aa          , Aa          , Aa          , Aa          , Aa          , Aa          , Aa          , Aa          , Aa          , Aa          , Aa          , Ha          , Ha          , Ha          
Ms          , Ha^Fpa      , Ha^Fpa      , Aa^Fpa      , Aa^Fpa      , Aa          , Aa          , Aa          , Aa          , Aa          , Rb          , Rb          , Rb          , Aa          , Aa          , Aa          , Aa          , Aa          , Aa          , Aa          , Aa          , Aa          , Aa          , Aa          , Aa          , Aa          , Dyb         , Dyb         , Dyb         , Dyb         , Aa          , Aa          , Aa          , Aa          , Aa          , Ha^Fpa      , Ha          
Ms          , Ha^Fpa      , Ha^Fpa      , Aa^Fpa      , Aa          , Aa          , Aa          , Aa          , Aa          , Aa          , Aa          , Rb          , Rb          , Aa          , Aa          , Aa          , Aa          , Aa          , Aa          , Aa          , Aa          , Aa          , Aa          , Aa          , Aa          , Aa          , Aa          , Dyb         , Aa          , Aa          , Aa          , Aa          , Aa          , Aa          , Ha^Fpa      , Ha^Fpa      , Ha          
Ms          , Ha^Fpa      , Ha^Fpa      , Aa          , Aa          , Aa          , Aa          , Aa          , Co          , Aa          , Aa          , Rb          , Rb          , Rb          , Aa          , Aa          , Coa         , Aa          , Aa          , Aa          , Aa          , Aa          , Aa          , Dyb         , Aa          , Aa          , Aa          , Aa          , Aa          , Aa          , Aa          , Aa          , Aa          , Aa          , Aa          , Ha^Fpa      , Aa          
Ha^Fpa      , Ha^Fpa      , Aa^Fpa      , Aa          , Ha          , Co          , Co          , Co          , Aa          , Aa          , Aa          , Coa         , Rb          , Rb          , Rb          , Coa         , Aa          , Coa         , Coa         , Coa         , Coa         , Aa          , Aa          , Aa          , Aa          , Aa          , Aa          , Aa          , Aa          , Dyb         , Aa          , Aa          , Ha          , Ha          , Ha^Fpa      , Aa          , Aa          
Ha^Fpa      , Ha^Fpa      , Aa          , Aa          , Aa          , Ha          , Aa          , Aa          , Aa          , Aa          , Aa          , Aa          , Aa          , Rb          , Rb          , Rb          , Rb          , Aa          , Aa          , Aa          , Aa          , Coa         , Aa          , Aa          , Aa          , Aa          , Ha          , Aa          , Ha          , Aa          , Ha          , Ha          , Ha          , Ha          , Ha          , Ha^Fpa      , Aa          
Ha^Fpa      , Ha^Fpa      , Aa          , Aa          , Aa          , Aa          , Aa          , Aa          , Aa          , Aa          , Aa          , Aa          , Aa          , Aa          , Rb          , Rb          , Rb          , Aa          , Aa          , Aa          , Aa          , Aa          , Aa          , Ha          , Ha          , Ha          , Ha          , Ha          , Ha          , Ha          , Ha          , Ha          , Ha          , Ha          , Ha          , Ha          , Ha          
