Mhyc^Mfyc, Mhyc, Mhyc, Mhyc, Mhyc, Mhyc, Mhyc, Mhyc, Mhyc, Spay, Spay, Spay, Spay, Spay, Spay, Spay, Spay, Mhyc, Mhyc, Mhyc, Mhyc, Mhyc, Mhyc, Mhyc, Mhyc, Mhyc, Mhyc, Mhyc, Mhyc, Mhyc, Mhyc, Mhyc, Mhyc, Mhyc, Mhyc, Mhyc, Mhyc, Mhyc, Mhyc, Mhyc, Mhyc, Mhyc
Mhyc, Mhyc, Mhyc, Mhyc, Mhyc, Mhyc, Mhyc, Mhyc, Mhyc, Mhyc, Mhyc, Spay, Spay^Esa, Spay, Spay, Spay, Spay, Spay, Spay, Mhyc, Mhyc, Mhyc, Mhyc, Mhyc, Mhyc, Mhyc, Mhyc, Mhyc, Mhyc, Mhyc, Mhyc, Mhyc, Mhyc, Mhyc, Mhyc, Mhyc, Mhyc, Mhyc, Mhyc, Mhyc, Mhyc, Mhyc
Mhyc, Mhyc, Mhyc, Mhyc, Mhyc, Mhyc, Mhyc, Mhyc, Mhyc, Mhyc, Mhyc, Mhyc, Mhyc, Aa, Aa, Spay, Spay^Esa, Spay, Spay, Spay, Spay, Mhyc, Mhyc, Mhyc, Mhyc, Mhyc, Mhyc, Mhyc, Mhyc, Mhyc, Mhyc, Mhyc, Mhyc, Mhyc, Mhyc, Mhyc, Mhyc, Mhyc, Mhyc, Mhyc, Mhyc, Mhyc
Mhyc, Mhyc, Mhyc, Mhyc, Mhyc, Mhyc, Mhyc, Mhyc, Mhyc, Mhyc, Mhyc, Mhyc, Mhyc, Mhyc, Mhyc, Aa, Aa, Aa, Aa, Spay, Spay, Spay, Spay, Spay^Esa, Spay, Spay^Esa, Spay, Mhyc, Spay, Spay, Spay, Mhyc, Mhyc, Mhyc, Mhyc, Mhyc, Mhyc, Mhyc, Mhyc, Mhyc, Mhyc, Mhyc
Mhyc, Mhyc, Mhyc, Mhyc, Mhyc, Mhyc, Mhyc, Mhyc, Mhyc, Mhyc, Mhyc, Mhyc, Mhyc, Mhyc, Mhyc, Mhyc, Mhyc, Mhyc, Mhyc, Aa, Mhyc, Spay, Spay, Spay, Spay, Spay, Spay, Spay, Spay^Edt, Spay^Ecf, Spay^Edt, Aa^Fpa, Mhyc, Mhyc, Mhyc, Mhyc, Mhyc, Mhyc, Mhyc, Mhyc, Mhyc, Mhyc
Mhyc, Mhyc, Mhyc, Mhyc, Mhyc, Mhyc, Mhyc, Mhyc, Mhyc, Mhyc, Mhyc, Mhyc, Mhyc, Mhyc, Mhyc, Mhyc, Mhyc, Mhyc, Mhyc, Mhyc, Mhyc, Mhyc, Spay, Spay, Spay, Spay, Aa, Spay, Aa, Spay^Edt, Aa, Aa, Mhyc, Mhyc, Mhyc, Mhyc, Mhyc, Mhyc, Mhyc, Mhyc, Mhyc, Mhyc
Mhyc, Mhyc, Mhyc, Mhyc, Mhyc, Mhyc, Aa^Fyak, Ms^Xm, Ms^Xm, Mhyc, Ms^Xm, Ms^Xm, Ms^Xm, Mhyc, Mhyc, Mhyc, Mhyc, Mhyc, Mhyc, Mhyc, Spay, Spay, Spay, Spay, Aa, Aa, Aa^Fpa, Aa, Mhyc, Aa, Mhyc, Mhyc, Mhyc, Mhyc, Mhyc, Mhyc, Mhyc, Mhyc, Mhyc, Mhyc, Mhyc, Mhyc
Mhyc, Mhyc, Mhyc, Mhyc, Mhyc, Mhyc, Aa, Aa, Aa, Ms^Xm, Aa^Fpa, Ms, Aa, Aa, Spay, Spay, Spay, Aa, Spay, Spay, Spay, Spay, Aa, Aa^Fpa, Mhyc, Mhyc, Mhyc, Mhyc, Mhyc, Mhyc, Mhyc, Mhyc, Mhyc, Mhyc, Mhyc, Mhyc, Mhyc, Mhyc, Mhyc, Mhyc, Mhyc, Mhyc
Mhyc, Mhyc, Mhyc, Mhyc, Mhyc, Mhyc, Mhyc, Aa, Aa, Aa^Fpa, Spay, Aa, Spay, Spay, Spay, Spay, Aa, Spay, Aa, Spay, Mhyc, Aa, Mhyc, Mhyc, Mhyc, Mhyc, Mhyc, Mhyc, Mhyc, Mhyc, Mhyc, Mhyc, Mhyc, Mhyc, Mhyc, Mhyc, Mhyc, Mhyc, Mhyc, Mhyc, Mhyc, Mhyc
Mhyc, Mhyc, Mhyc, Mhyc, Mhyc, Mhyc, Aa, Aa, Spay, Aa, Spay, Spay, Spay, Spay, Aa^Esa, Aa, Aa^Fpa, Aa, Mhyc, Mhyc, Mhyc, Mhyc, Mhyc, Mhyc, Mhyc, Mhyc, Mhyc, Mhyc, Mhyc, Mhyc, Mhyc, Mhyc, Mhyc, Mhyc, Mhyc, Mhyc, Mhyc, Mhyc, Mhyc, Mhyc, Mhyc, Mhyc
Mhyc, Mhyc, Mhyc, Mhyc, Aa^Fpa, Aa^Fpa, Spay, Spay, Spay^Esa, Spay, Spay, Spay, Aa, Aa, Mhyc, Mhyc, Mhyc, Mhyc, Mhyc, Mhyc, Aa^Fpa, Mhyc, Mhyc, Mhyc, Mhyc, Mhyc, Mhyc, Mhyc, Mhyc, Mhyc, Mhyc, Mhyc, Mhyc, Mhyc, Mhyc, Mhyc, Mhyc, Mhyc, Mhyc, Mhyc, Mhyc, Mhyc
Mhyc, Mhyc, Mhyc, Mhyc, Mhyc, Aa, Aa, Aa^Aybl, Spay, Spay, Aa^Fpa, Aa, Mhyc, Mhyc, Mhyc, Mhyc, Mhyc, Mhyc, Mhyc, Aa, Aa, Aa, Aa^Fpa, Mhyc, Mhyc, Mhyc, Mhyc, Mhyc, Mhyc, Mhyc, Mhyc, Mhyc, Mhyc, Mhyc, Mhyc, Mhyc, Mhyc, Mhyc, Mhyc, Mhyc, Mhyc, Mhyc
Mhyc, Mhyc, Mhyc, Mhyc, Mhyc, Mhyc, Mhyc, Aa, Aa, Spay, Spay, Aa, Aa, Mhyc, Mhyc, Mhyc, Mhyc, Mhyc, Mhyc, Mhyc, Mhyc, Aa, Mhyc, Mhyc, Mhyc, Mhyc, Mhyc, Mhyc, Mhyc, Mhyc, Mhyc, Mhyc, Mhyc, Mhyc, Mhyc, Mhyc, Mhyc, Mhyc, Mhyc, Mhyc, Mhyc, Mhyc
Mhyc, Mhyc, Mhyc, Mhyc, Mhyc, Mhyc, Mhyc, Mhyc, Mhyc, Aa, Aa, Spay, Spay, Aa, Spay^Esa, Mhyc, Mhyc, Mhyc, Mhyc, Mhyc, Mhyc, Mhyc, Mhyc, Mhyc, Mhyc, Mhyc, Mhyc, Mhyc, Mhyc, Mhyc, Mhyc, Mhyc, Mhyc, Mhyc, Mhyc, Mhyc, Mhyc, Mhyc, Mhyc, Mhyc, Mhyc, Mhyc
Mhyc, Mhyc, Mhyc, Mhyc, Mhyc, Mhyc, Mhyc, Mhyc, Mhyc, Mhyc, Mhyc, Aa, Spay, Spay, Spay, Spay^Esa, Aa^Esa, Mhyc, Aa^Esa, Mhyc, Mhyc, Mhyc, Mhyc, Mhyc, Mhyc, Mhyc, Mhyc, Mhyc, Mhyc, Mhyc, Mhyc, Mhyc, Mhyc, Mhyc, Mhyc, Mhyc, Mhyc, Mhyc, Mhyc, Mhyc, Mhyc, Mhyc
Mhyc, Mhyc, Mhyc, Mhyc, Mhyc, Mhyc, Mhyc, Mhyc, Mhyc, Mhyc, Ms^Xm, Ms^Xm, Aa, Spay, Spay, Spay, Spay, Aa^Esa, Mhyc, Mhyc, Mhyc, Mhyc, Mhyc, Mhyc, Mhyc, Mhyc, Mhyc, Mhyc, Mhyc, Mhyc, Mhyc, Mhyc, Mhyc, Mhyc, Mhyc, Mhyc, Mhyc, Mhyc, Mhyc, Mhyc, Mhyc, Ms^Xm
Ms^Xm, Mhyc, Mhyc, Mhyc, Mhyc, Mhyc, Mhyc, Mhyc, Ms^Xm, Ms^Xm, Aa, Aa, Aa^Aybl, Aa, Spay, Spay^Esa, Spay, Aa, Mhyc, Mhyc, Mhyc, Mhyc, Mhyc, Mhyc, Mhyc, Mhyc, Mhyc, Mhyc, Ms^Xm, Ms^Xm, Ms^Xm, Ms^Xm, Ms^Xm, Ms^Xm, Ms^Xm, Mhyc, Ms^Xm, Mhyc, Ms^Xm, Ms^Xm, Ms^Xm, Ms^Xm
Ms^Xm, Ms^Xm, Ms^Xm, Mhyc, Mhyc, Ms^Xm, Ms^Xm, Mhyc, Aa, Aa^Voa, Aa, Aa^Fpa, Aa, Aa, Spay, Spay, Spay, Spay, Spay, Ms^Xm, Ms^Xm, Mhyc, Ms^Xm, Mhyc, Ms^Xm, Ms^Xm, Ms^Xm, Ms^Xm, Ms^Xm, Ms^Xm, Ms^Xm, Ms, Ms, Ms^Xm, Ms, Ms^Xm, Ms^Xm, Ms^Xm, Ms^Xm, Ms^Xm, Ms^Xm, Ms^Xm
Ms^Xm, Ms^Xm, Ms^Xm, Ms^Xm, Ms^Xm, Ms^Xm, Ms^Xm, Ms^Xm, Aa, Aa, Aa, Aa, Ms^Xm, Aa, Aa, Spay, Spay, Spay^Esa, Spay, Ms^Xm, Ms^Xm, Ms^Xm, Ms^Xm, Ms^Xm, Ms, Ms, Ms, Ms, Ms, Ms, Ms, Ms^Xm, Ms^Xm, Ms^Xm, Ms^Xm, Ms^Xm, Ms^Xm, Ms^Xm, Ms^Xm, Ms^Xm, Ms^Xm, Ms^Xm
Ms^Xm, Ms^Xm, Ms, Ms^Xm, Ms^Xm, Ms^Xm, Ms^Xm, Ms, Coa, Aa, Ms, Ms^Xm, Ms^Xm, Ms, Ha, Aa, Aa^Voa, Spay, Spay, Ms, Ms, Ms^Xm, Ms^Xm, Ms, Ha, Ha, Ha^Fpa, Ms, Ms, Ms, Ms^Xm, Ms, Ms, Ms, Ms^Xm, Ms, Ms, Ms^Xm, Ms^Xm, Ms^Xm, Ms^Xm, Ms^Xm
Ms^Xm, Ms^Xm, Ms^Xm, Ms^Xm, Ms, Ms^Xm, Ms^Xm, Ms, Ms, Ms, Ha, Ms^Xm, Ms, Ms^Xm, Ha, Aa, Aa, Spay, Spay, Spay, Spay, Ha, Ha, Ha, Aa^Voa, Aa, Aa, Ha^Fpa, Ha^Fpa, Ha^Fpa, Ha^Fpa, Ms, Ms, Ms^Xm, Ms, Ms, Ms, Ms, Ms, Ms^Xm, Ms^Xm, Ms^Xm
Ms^Xm, Ms^Xm, Ms^Xm, Ms, Ms, Ms, Ms, Ms^Xm, Ha, Ha, Ha, Coa, Ha, Ha, Coa, Ms, Ha, Aa, Koa, Spay, Spay, Spay, Coa, Aa, Aa, Aa, Coa, Aa, Ha, Ha^Fpa, Ha, Ms, Ms, Ms, Ha^Fpa, Ha^Fpa, Ha^Fpa, Ms, Ms, Ms^Xm, Ms^Xm, Ms^Xm
Ms^Xm, Ms^Xm, Ms^Xm, Ms, Ms, Ms, Ha, Ha, Ha^Fpa, Ha, Aa, Aa, Aa, Ha, Aa, Ha, Ha, Coa, Coa, Coa, Spay, Spay, Spay, Aa, Aa, Aa, Ha, Ha, Ms, Ms, Ms, Ms^Xm, Ms, Ha^Fpa, Ha, Ha, Ms, Ms, Ms, Ms, Ms^Xm, Ms^Xm
Ms, Ms^Xm, Ms^Xm, Ms^Xm, Ms, Ms, Ha, Ha, Ha, Ha, Aa^Fpa, Aa^Fpa, Aa, Aa, Aa, Aa^Voa, Aa, Aa, Aa, Aa, Spay, Spay, Spay, Aa, Aa, Ha, Ha, Ms, Ms^Xm, Ms^Xm, Ms^Xm, Ms, Ha, Ha, Ha, Ms, Ms, Ms, Ms^Xm, Ms, Ms^Xm, Ms
Ms^Xm, Ms^Xm, Ms, Ms, Ms, Ha, Aa, Aa^Fpa, Aa, Aa, Ha, Ha^Fpa, Ha, Ha, Ha, Aa, Aa, Aa, Aa^Fpa, Aa, Spay, Spay, Spay, Coa, Aa, Ha, Ms, Ms, Ms^Xm, Ms^Xm, Ms^Xm, Ms, Ha, Ha, Ha, Ha, Ms, Ms, Ms^Xm, Ms^Xm, Ms, Ms
Ms^Xm, Ms^Xm, Ms, Ms, Ms, Aa, Aa, Aa, Ha, Ha, Mm, Mm, Mm, Mm, Ms, Ha, Ha, Ha, Ha, Ha, Spay, Spay^Esa, Spay, Spay, Ha, Ha, Ms, Ms^Xm, Ms, Ms^Xm, Ms, Ms, Ha, Aa, Aa, Ha, Ms, Ms, Ms, Ms, Ms, Ms
Ms^Xm, Ms^Xm, Ms, Ms, Ms, Ha^Fpa, Ha, Ha, Mm, Mm, Mm, Mm, Uh, Mm, Mm, Ha, Ha, Ha, Ms^Xm, Ms, Ha, Spay, Spay, Spay, Spay, Ha, Ha, Ms, Ha, Ms, Ha^Fpa, Ha^Fpa, Ha^Fpa, Aa, Ha, Ha, Ha, Ms, Ms, Ms, Ms, Ms
Ms^Xm, Ms^Xm, Ms^Xm, Ms, Ms, Ms, Ms, Mm, Mm^Xm, Mm^Xm, Mm, Uh, Ql, Uh, Mm, Mm, Mm, Ms, Ha, Ms, Ha, Aa^Fpa, Spay, Spay^Esa, Spay, Aa, Aa, Ha, Ha, Ha, Ha^Fpa, Ha^Fpa, Aa^Fpa, Aa^Fpa, Aa^Fpa, Ha, Ha^Fpa, Ha^Fpa, Hh^Fp, Ms, Ha, Ha
Ms^Xm, Ms^Xm, Ms^Xm, Ms, Ms, Ms, Ms, Mm, Ms, Mm, Mm, Uh, Uh, Uh, Mm, Mm, Mm, Ms, Ha, Ha, Aa, Aa, Spay, Spay, Aa, Aa, Aa, Ha^Fpa, Ha, Ha, Aa, Aa, Aa^Fpa, Aa^Fpa, Spay, Ha^Fpa, Hh^Fp, Hh^Fp, Uh, Hh^Fp, Hh^Fp, Ha
Ms^Xm, Ms^Xm, Ms^Xm, Ms, Ms, Ha, Ha^Fpa, Ha^Fpa, Ms, Mm, Mm, Mm, Hh^Fp, Hh^Fp, Hh^Fp, Hh^Fp, Aa^Fpa, Mm, Ha, Ha, Aa, Spay, Spay^Esa, Spay, Coa, Aa, Aa, Aa, Ha, Ha, Aa, Aa, Aa^Fpa, Aa^Voa, Spay, Re, Re, Uh, Ql, Uh, Mm, Ms
Ms^Xm, Ms^Xm, Ms^Xm, Ms, Ms, Ha, Ha, Ha^Fpa, Ha, Ms, Ms, Ms, Ha^Fpa, Hh^Fp, Ha^Fpa, Gs^Fp, Aa^Fpa, Aa^Fpa, Aa, Aa, Aa, Spay, Spay, Spay, Aa, Aa, Aa, Aa^Esa, Spay, Ha, Spay, Spay, Spay, Spay, Spay, Spay, Re, Uh, Uh, Uh, Mm, Ms
Ms^Xm, Ms^Xm, Ms^Xm, Ms, Aa, Aa^Voa, Aa, Ha, Aa, Aa, Aa, Ha, Aa, Ha^Fpa, Aa^Fpa, Ha^Fpa, Aa^Fpa, Aa^Fpa, Aa^Fpa, Aa^Fpa, Aa, Aa, Spay, Spay, Spay, Aa^Fpa, Aa, Aa, Ai, Spay, Aa, Ha, Ms, Ha, Ms, Ha, Ha, Ms, Ms, Ms, Ms, Ms
Ms^Xm, Ms^Xm, Ms^Xm, Ms, Ms, Aa, Ha, Aa, Ms, Aa, Ms, Ms, Ms^Xm, Aa, Ha, Aa^Fpa, Aa, Aa^Feta, Aa, Aa, Aa, Aa^Fpa, Spay, Spay, Spay, Aa, Aa, Ai, Wo, Ai, Ha, Ms, Ms^Xm, Ms, Ms^Xm, Ms, Ms, Ha, Ms, Ms, Ms, Ms
Ms^Xm, Ms^Xm, Ms^Xm, Ms^Xm, Ms^Xm, Ha, Ms, Ha, Ms^Xm, Ms, Ms^Xm, Ms^Xm, Ms^Xm, Ms^Xm, Ha, Aa, Aa, Aa, Coa, Coa, Coa, Rra, Spay, Spay, Ha, Spay, Spay, Ai, Ai, Ai, Ha, Ms, Ms^Xm, Ms^Xm, Ms^Xm, Ms^Xm, Ha, Ha, Ms, Ms, Ms^Xm, Ms
Ms^Xm, Ms^Xm, Ms^Xm, Ms^Xm, Ms^Xm, Ms^Xm, Ms^Xm, Ms, Ms, Ms^Xm, Ms^Xm, Ms^Xm, Ms^Xm, Ms^Xm, Ha, Aa^Voa, Aa, Rra^Esa, Coa, 2 Koa, Coa, Rra^Esa, Spay, Spay, Ha, Aa, Aa, Spay, Spay^Voa, Aa, Aa, Ha, Aa, Ms, Ha, Ms, Ms, Ha, Ha, Ms, Ms^Xm, Ms^Xm
Ms^Xm, Ms^Xm, Ms, Ms^Xm, Ms^Xm, Ms^Xm, Ms^Xm, Ms^Xm, Ms, Ms, Ms, Ms, Ms, Ha, Aa, Aa, Spay, Rra, Rra, Coa, Rra^Esa, Rra, Spay, Spay, Ha, Ha^Fpa, Aa^Fpa, Spay, Spay, Aa, Aa, Aa^Fpa, Aa^Fpa, Aa, Aa^Fpa, Aa, Aa, Aa, Aa, Ms, Ha, Ms
Ms^Xm, Ms^Xm, Ms, Ms, Ha, Ms^Xm, Ha, Ms^Xm, Ms, Ms, Ha, Ms, Ha, Ha, Aa^Fpa, Spay, Spay, Spay^Efs, Spay, Rra, Spay, Spay^Efs, Ha, Ha, Ms, Ha^Fpa, Ha, Aa, Aa^Esa, Aa, Ai, Aa, Aa, Aa^Fpa, Aa^Fpa, Aa^Fpa, Aa^Fpa, Aa^Fpa, Ha^Fpa, Ha, Ha, Ha
Ms^Xm, Ms^Xm, Ms, Ms, Ha, Ms, Ms, Ms, Ms, Ms, Ha, Ha, Aa^Fpa, Aa^Vct, Spay, Spay, Spay, Spay, Coa, Spay, Spay, Spay, Aa^Fpa, Ha^Fpa, Ha, Ha, Ha, Ha, Ha, Ai, Ai, Ai^Esa, Ai, Aa, Aa^Fpa, Aa^Fpa, Aa^Fpa, Aa^Fpa, Ha^Fpa, Ha^Fpa, Ha, Ha
Ms^Xm, Ms^Xm, Ms^Xm, Ms, Ha^Fpa, Ha^Fpa, Aa^Fpa, Ha, Aa, Ha, Aa, Aa, Aa, Spay, 1 Spay, Spay, Aa^Fpa, Aa, Aa, Aa, Aa, Aa^Esa, Aa, Aa^Fpa, Aa, Aa, Ha, Ha, Ha^Fpa, Ai, Ha, Ai, Aa, Aa^Fpa, Aa^Fpa, Aa^Fpa, Ha^Fpa, Ha^Fpa, Aa^Fpa, Ha^Fpa, Ha, Ha
Ms^Xm, Ms^Xm, Ms, Ms, Ha, Ha^Fpa, Aa, Aa, Aa^Vct, Aa, Spay, Spay, Spay, Spay, Spay, Aa, Aa, Aa, Aa, Aa, Ms, Aa, Gg^Vc, Aa, Co, Spay, Spay, Ha, Ms, Aa, Ha, Ms, Aa, Aa^Esa, Aa, Aa^Fpa, Aa^Fpa, Aa^Fpa, Ms, Ha^Fpa, Ms, Ms
Ms^Xm, Ms, Ms, Ha, Ha, Ha, Ms, Ha, Aa, Aa, Cea, Cea, Cea, Spay, Spay^Vct, Aa, Ha, Ha, Ms, Ms, Uh, Hh^Fp, Hh^Fp, Co, Rb, Re, Re, Ha, Ha, Aa, Ha, Ha, Ha, Aa, Ha, Aa, Ha, Aa^Fpa, Ms^Xm, Ms, Ms, Ms
Ms^Xm, Ms^Xm, Ms, Ha^Fpa, Ha, Ms, Ha, Ha, Aa^Vct, Aa, Aa, Kea, Cea, Spay, Spay, Aa, Ha, Ms, Ms^Xm, Mm, Mm, Uh, Ql, Uh, Mm, Rb, Coa, Ha, Ms, Ms, Ms^Xm, Ms^Xm, Ms^Xm, Ms, Ms^Xm, Ha, Ms^Xm, Ms^Xm, Ms^Xm, Ms^Xm, Ms^Xm, Ms
Ms^Xm, Ms^Xm, Ms, Ms, Ha, Ha, Aa, Aa, Aa, Aa, Coa, Aa, Spay, Spay, Spay, Spay^Vct, Aa, Ha, Ha^Fpa, Ms, Mm, Uh, Uh, Uh, Mm, Co, Ms, Ms, Ms^Xm, Ms^Xm, Ms^Xm, Ms^Xm, Ms^Xm, Ms^Xm, Ms^Xm, Ms^Xm, Ms^Xm, Ms^Xm, Ms^Xm, Ms^Xm, Ms^Xm, Ms
Ms^Xm, Ms^Xm, Ms, Ms, Ha, Aa, Ms, Ha, Aa, Aa, Aa, Aa, Spay, Spay, Spay, Spay, Aa, Aa^Fpa, Ha^Fpa, Ha^Fpa, Hh, Mm, Mm, Mm, Ha, Ha, Ms, Ms, Ms^Xm, Ms^Xm, Ms^Xm, Ms^Xm, Ms^Xm, Ms^Xm, Ms^Xm, Ms^Xm, Ms^Xm, Ms^Xm, Ms^Xm, Ms^Xm, Ms^Xm, Ms
Ms^Xm, Ms^Xm, Ms, Ms, Ms, Ms, Ha, Ha, Aa, Aa^Fpa, Ha, Aa, Aa^Fpa, Spay, Spay, Spay, Spay, Aa, Aa^Fpa, Ha, Ha, Mm, Ms, Ms, Ha, Aa, Aa, Ms^Xm, Ms^Xm, Ms^Xm, Ms^Xm, Ms^Xm, Ms^Xm, Ms^Xm, Ms^Xm, Ms^Xm, Ms^Xm, Ms^Xm, Ms^Xm, Ms^Xm, Ms^Xm, Ms^Xm
Ms^Xm, Ms^Xm, Ms, Ms, Ms^Xm, Ms, Ms, Ms, Ms, Aa, Aa, Aa, Aa, Spay^Esa, Spay, Spay^Es, Spay, Aa, Aa, Aa, Aa^Esa, Ha, Ha, Ha, Ha, Aa^Esa, Aa, Ms, Ms, Ms^Xm, Ms^Xm, Ms^Xm, Ms^Xm, Ms^Xm, Ms^Xm, Ms^Xm, Ms^Xm, Ms^Xm, Ms^Xm, Ms^Xm, Ms^Xm, Ms^Xm
Ms^Xm, Ms^Xm, Ms^Xm, Ms^Xm, Ms, Ms, Ms, Ms, Ha, Aa, Ha, Aa, Spay, Spay, Spay, Spay, Spay, Spay, Aa, Aa, Aa, Aa, Aa^Fpa, Ha^Fpa, Ha, Ha, Ha, Aa, Aa^Fpa, Ms, Ms, Ms, Ms, Ms, Ms, Ms^Xm, Ms^Xm, Ms^Xm, Ms^Xm, Ms^Xm, Ms^Xm, Ms^Xm
Ms^Xm, Ms^Xm, Ms, Ms, Ms, Ms, Ha, Ha, Ha^Fpa, Ha, Ha, Ai, Spay^Voa, Spay, Aa^Fpa, Spay, Spay, Aa, Aa^Fpa, Spay, Spay, Aa, Aa, Aa, Ms, Ms^Xm, Ms, Ha, Aa^Fpa, Aa^Fpa, Aa^Fpa, Ms, Aa, Ms, Ms, Ms, Ha^Fpa, Ms^Xm, Ms^Xm, Ms^Xm, Ms, Ms^Xm
Ms^Xm, Ms^Xm, Ms, Ms, Ms^Xm, Ms^Xm, Ha, Ha^Fpa, Ha^Fpa, Ha^Fpa, Aa, Aa, Aa, Aa, Ha, Spay, Spay, Spay, Spay, Spay, Spay, Spay, Spay, Ha, Ms, Ms^Xm, Ha, Ha, Aa, Aa^Fpa, Aa^Fpa, Aa^Fpa, Aa, Aa^Fpa, Aa, Aa, Ha^Fpa, Ha^Fpa, Ha^Fpa, Ms, Ms, Ms^Xm
Ms^Xm, Ms^Xm, Ms^Xm, Ms^Xm, Ms, Ms, Ms, Ha, Ha, Ha, Ms, Ha, Ha, Ha, Ha^Fpa, Ha, Aa, Spay, Aa, Spay, Spay^Esa, Spay, Spay, Aa, Aa, Ha, Aa, Aa, Spay^Voa, Aa, Ha^Fpa, Ha^Fpa, Ms^Xm, Ms, Ms, Ha^Fpa, Ha^Fpa, Ha^Fpa, Ms, Ms, Ms^Xm, Ms^Xm
Ms^Xm, Ms^Xm, Ms^Xm, Ms, Ms, Ms, Ms, Ms, Ms, Ms^Xm, Ms, Ms^Xm, Ha, Aa^Fpa, Aa, Aa, Aa, Aa, Coa, Aa, Spay, Spay, Coa, Spay, Spay, Aa, Spay, Spay, Spay, Aa, Ms, Ms, Ms^Xm, Ms^Xm, Ms^Xm, Ms, Ha^Fpa, Ha^Fpa, Ms, Ms, Ms^Xm, Ms
Ms^Xm, Ms^Xm, Ms^Xm, Ms^Xm, Ms, Ms, Ms, Ms^Xm, Ms, Ms, Ha, Ms, Ha, Aa, Aa, Coa, Ai, Aa, Aa, Aa, Aa, Spay, Spay, Spay, Spay, Coa, Aa, Aa, Coa, Aa, Aa, Ms, Ha^Fpa, Ms, Ms, Ms, Ha^Fpa, Ms^Xm, Ms^Xm, Ms, Ms^Xm, Ms^Xm
Ms^Xm, Ms^Xm, Ms^Xm, Ms^Xm, Ms, Ms, Ms, Ms, Ms, Ha^Fpa, Ha, Ha, Ha, Ha, Ha, Ai, Tyb, Ai, Ai, Ai, Aa, Spay, Spay, Spay, Spay, Spay, Aa, Aa, Aa, Aa, Aa, Aa, Aa, Aa, Ha^Fpa, Ha^Fpa, Ha^Fpa, Ha^Fpa, Ms, Ms, Ms^Xm, Ms^Xm
Ms^Xm, Ms^Xm, Ms^Xm, Ms^Xm, Ms, Ms, Ms, Ms, Ha, Ha, Aa, Coa, Aa, Aa, Ai, Ai, Ss, Ss, Tyb, Ai, Ai, Spay, Spay, Spay, Spay, Aa, Aa^Fpa, Aa, Aa, Aa, Ha, Coa, Ha, Aa^Fpa, Aa^Fpa, Aa^Fpa, Aa^Fpa, Ms, Ms, Ms^Xm, Ms^Xm, Ms^Xm
Ms^Xm, Ms^Xm, Ms^Xm, Ms^Xm, Ms^Xm, Ms, Ms, Ms, Ms, Ha, Ai, Ai, Ai^Fpa, Aa^Fpa, Ha, Ai, Ai, Ss, Tyb, Ss, Ai, Spay, Spay, Spay, Spay, Aa, Aa, Aa, Aa^Fpa, Ha, Ha, Ha, Ms, Ha, Aa, Aa, Aa, Ms, Ms, Ms^Xm, Ms^Xm, Ms^Xm
Ms^Xm, Ms^Xm, Ms^Xm, Ms^Xm, Ms^Xm, Ms, Ms^Xm, Ms, Ms, Ms, Ms, Ai^Fpa, Aa^Fpa, Ha^Fpa, Ha^Fpa, Ha, Ai, Ai, Ai, Ai, Aa^Fpa, Spay, Spay, Spay, Spay, Spay, Spay, Aa, Aa, Ha^Fpa, Aa, Ha, Ha, Ha, Ha^Fpa, Aa, Ms, Ms, Ms, Ms^Xm, Ms^Xm, Ms^Xm
Ms^Xm, Ms^Xm, Ms^Xm, Ms^Xm, Ms^Xm, Ms^Xm, Ms^Xm, Ms^Xm, Ms, Ms^Xm, Ms^Xm, Ms^Xm, Ms, Aa^Fpa, Ha, Aa, Aa, Aa, Aa, Aa^Fpa, Aa, Spay, Aa, Spay, Spay, Spay, Spay, Spay, Spay, Aa, Aa, Aa, Ha, Ha, Ms, Ms, Ms, Ms, Ms^Xm, Ms^Xm, Ms^Xm, Ms^Xm
Ms^Xm, Ms^Xm, Ms^Xm, Ms^Xm, Ms^Xm, Ms^Xm, Ms^Xm, Ms^Xm, Ms, Ms, Ms, Ms^Xm, Aa, Ms, Ms, Ha, Aa, Aa, Aa, Aa, Aa, Aa, Aa, Aa, Aa, Spay, Spay, Spay, Spay, Aa, Ha, Ha, Ms, Ms, Ms, Ms, Ms, Ms, Ms^Xm, Ms^Xm, Ms^Xm, Ms^Xm
