Gg, Gs^Ft, Gs^Ft, Gs^Ft, Gs^Ft, Gs^Ft, Gg, Gs^Ft, Gs^Ft, Gs^Ft, Gs^Ft, Gs^Ft, Gll^Ftr, Gll^Ftr, Gll^Ftr, Gs^Ft, Gll^Ftr, Gs^Ft, Gs^Ft, Gs^Ft, Ss, Gs^Ft, Ss, Ss, Gll^Ftr, Gll^Ftr, Gll^Ftr, Gll^Ftr, Ss, Gg, Ss, Gg, Gll^Ftr, Gg, Ss, Gg, Hh, Hh, Hh, Mm, Mm, Gg, Mm, Hh, Mm, Hh, Mm, Mm, Mm, Mm, Mm, Mm, Mm, Gg, Mm, Gg, Mm, Gd
Gg, Gg, Gg, Gg, Gg, Gs^Ft, Gs^Ft, Gg, Gs^Ft, Gs^Ft, Gs^Ft, Gs^Ft, Gs^Ft, Gll^Ftr, Gs^Ft, Gll^Ftr, Gll^Ftr, Gll^Ftr, Gs^Ft, Gs^Ft, Gs^Ft, Ss, Ss, Ss, Gll^Ftr, Gll^Ftr, Gll^Ftr, Gll^Ftr, Ss, Ss, Ss, Ss, Gll^Ftr, Ss, Ss, Gg, Hh, Hh, Hh, Hh, Hh, Mm, Mm, Mm, Mm, Mm, Mm, Mm, Mm, Mm, Mm, Mm, Mm, Mm, Mm, Mm, Mm, Gd
Gs^Ft, Gs^Ft, Gs^Ft, Gg, Gg, Gg, Gg, Gg, Gg, Gs^Ft, Gs^Ft, Gs^Ft, Gs^Ft, Gs^Ft, Gs^Ft, Gs^Ft, Gs^Ft, Gs^Ft, Gll^Ftr, Gs^Ft, Gs^Ft, Gs^Ft, Gs^Ft, Ss, Gll^Ftr, Gll^Ftr, Gll^Ftr, Gll^Ftr, Ss, Ss, Ss, Gs^Ft, Gll^Ftr, Ss, Ss, Gg, Co, Gg, Hh, Hh, Hh, Mm, Mm, Mm, Mm, Mm, Mm, Mm, Mm, Mm, Mm, Mm, Mm, Mm, Mm, Mm, Mm, Gd
Gll^Ftr, Gll^Ftr, Gs^Ft, Gs^Ft, Gs^Ft, Gs^Ft, Gs^Ft, Gs^Ft, Gs^Ft, Gg, Gg, Gs^Ft, Gg, Gs^Ft, Gs^Ft, Gs^Ft, Gs^Ft, Gs^Ft, Gs^Ft, Gll^Ftr, Gll^Ftr, Gs^Ft, Gs^Ft, Ss, Gll^Ftr, Gll^Ftr, Gll^Ftr, Gll^Ftr, Gs^Ft, Ss, Ss, Ss, Ss, Ss, Gg, Gg, Co, 6 Ko, Gg, Hh, Hh, Hh, Hh, Mm, Mm, Mm, Mm, Mm, Mm, Mm, Mm, Mm, Mm, Mm, Mm, Mm, Mm, Gd
Gll^Ftr, Gll^Ftr, Gll^Ftr, Gll^Ftr, Gs^Ft, Gs^Ft, Gs^Ft, Gs^Ft, Gs^Ft, Gs^Ft, Gs^Ft, Gg, Gs^Ft, Gg, Gs^Ft, Gs^Ft, Gs^Ft, Gs^Ft, Gll^Ftr, Gs^Ft, Gs^Ft, Gll^Ftr, Gll^Ftr, Gll^Ftr, Gll^Ftr, Gll^Ftr, Gs^Ft, Gs^Ft, Ss, Ss, Ss, Ss, Gs^Ft, Gg, Gs^Ft, Gg, Gg, Co, Gg, Gd^Vo, Hh, Hh, Hh, Mm, Mm, Mm, Mm, Mm, Mm, Mm, Mm, Mm, Hh, Mm, Mm, Mm, Mm, Gd
Gll^Ftr, Gll^Ftr, Gs^Ft, Gs^Ft, Gs^Ft, Gs^Ft, Gll^Ftr, Gs^Ft, Gg, Gg, Gs^Ft, 1 Gs^Ft, Gs^Ft, Gg, Gg, Gs^Ft, Gs^Ft, Gs^Ft, Gll^Ftr, Gll^Ftr, Gs^Ft, Gll^Ftr, Gs^Ft, Gs^Ft, Gll^Ftr, Gs^Ft, Gs^Ft, Gs^Ft, Ss, Gs^Ft, Gs^Ft, Gs^Ft, Gs^Ft, Gs^Ft, Gs^Ft, Gg, Gg, Gg, Hh, Hh, Hh, Mm, Hh, Hh, Hh, Hh, Mm, Mm, Mm, Mm, Hh, Hh, Mm, Mm, Mm, Mm, Mm, Gd
Ss, Ss, Gs^Ft, Gs^Ft, Gll^Ftr, Gs^Ft, Gll^Ftr, Gs^Ft, Gs^Ft, Gg, Gg, Gs^Ft, Gg, Gg, Gg, Gs^Ft, Gs^Ft, Gll^Ftr, Gll^Ftr, Gll^Ftr, Gs^Ft, Gs^Ft, Gs^Ft, Gs^Ft, Gs^Ft, Gs^Ft, Gll^Ftr, Gll^Ftr, Ss, Gs^Ft, Gll^Ftr, Gs^Ft, Gs^Ft, Gs^Ft, Gs^Ft, Gs^Ft, Gg, Gg, Hh, Hh, Hh, Hh, Hh, Mm, Hh, Hh^Vo, Mm, Mm, Mm, Hh, Mm, Mm, Mm, Mm, Mm, Mm, Mm, Gd
Ss, Gs^Ft, Gs^Ft, Gs^Ft, Gll^Ftr, Gll^Ftr, Gll^Ftr, Gs^Ft, Gs^Ft, Gs^Ft, Gs^Ft, Gg, Gg, Gg, Gg, Gs^Ft, Gs^Ft, Gs^Ft, Gs^Ft, Gs^Ft, Gs^Ft, Gs^Ft, Gs^Ft, Gs^Ft, Gll^Ftr, Gll^Ftr, Gll^Ftr, Gll^Ftr, Gs^Ft, Gll^Ftr, Gs^Ft, Gs^Ft, Gll^Ftr, Gs^Ft, Gs^Ft, Gs^Ft, Gg, Gg, Hh, Hh, Hh, Hh, Gll^Fp, Hh, Hh, Hh, Mm, Mm, Hh, Hh, Mm, Mm, Mm, Mm, Mm, Mm, Mm, Gd
Ss, Ss, Ss, Gs^Ft, Gs^Ft, Gll^Ftr, Gll^Ftr, Gll^Ftr, Gll^Ftr, Gll^Ftr, Gll^Ftr, Gs^Ft, Gs^Ft, Gg, Gg, Gs^Ft, Gs^Ft, Gs^Ft, Gs^Ft, Gs^Ft, Gs^Ft, Gs^Ft, Gs^Ft, Gs^Ft, Gll^Ftr, Gll^Ftr, Gll^Ftr, Gll^Ftr, Gs^Ft, Gs^Ft, Ss, Gs^Ft, Gll^Ftr, Gg, Gg, Gg, Gg, Gg, Hh, Hh, Hh, Gll^Fp, Hh, Gll^Fp, Hh, Hh, Hh, Hh, Mm, Mm, Mm, Mm, Mm, Mm, Mm, Mm, Mm, Gd
Gll^Ftr, Gll^Ftr, Gll^Ftr, Ss, Gs^Ft, Gs^Ft, Gs^Ft, Gll^Ftr, Gs^Ft, Gll^Ftr, Gs^Ft, Gs^Ft, Gs^Ft, Gs^Ft, Gg, Gg, Rb, Rb, Rb, Rb, Rb, Gs^Ft, Rb, Gs^Ft, Gs^Ft, Gs^Ft, Gs^Ft, Gs^Ft, Ss, Gs^Ft, Ss, Gs^Ft, Gg, Gg, Gg, Gg, Gg, Gg, Gs, Hh, Gs, Hh, Gg, Hh, Hh, Hh, Hh, Mm, Mm, Mm, Mm, Mm, Mm, Mm, Mm, Mm, Mm, Mm
Ss, Gll^Ftr, Gll^Ftr, Ss, Ss, Ss, Ss, Ss, Gs^Ft, Gs^Ft, Gs^Ft, Gs^Ft, Gs^Ft, Gs^Ft, Rb, Gg, Rb, Rb^Ytot, Rb, Rb, Rb, Rb, Rb, Gg, Gg, Gs^Ft, Gll^Ftr, Gll^Ftr, Ss, Ss, Gg, Gg, Gg, Gs^Fds, Gg, Gg, Gs^Vc, Gs, Gg, Gs, Gg, Gg, Gll^Fp, Gll^Fp, Hh, Hh, Hh, Hh, Mm, Mm, Hh^Vo, Mm, Mm, Mm, Mm, Mm, Mm, Mm
Gs^Ft, Gll^Ftr, Gll^Ftr, Gll^Ftr, Gs^Ft, Gs^Ft, Gs^Ft, Gs^Ft, Ss, Ss, Ss, Ss, Ss, Ss, Rb, Rb^Ytwt, Rb, Rb, Gg^Fet, Rb, Rb, Rb, Rb, Gg^Ve, Gg, Gg, Gg, Ss, Ss, Gg, Gg, Gg, Gg, Gg, Gg, Gg, Gg, Gs, Gg, Gg, Gg^Fms, Gg, Gg^Fp, Hh, Hh^Fp, Hh, Hh, Hh, Hh, Hh, Hh, Mm, Mm, Mm, Hh, Mm, Mm, Mm
Gll^Ftr, Gs^Ft, Gs^Ft, Ss, Gs^Ft, Gll^Ftr, Ss, Ss, Ss, Gs^Ft, Ss, Ss, Ss, Rb, Rb, Rb, Rb, Gg, Gg, Gg, Rb, Rb, Ss, Gg, Gg, Gg, Gs^Fds, Gs^Fds, Ss, Gg, Gg, Gg, Gg, Gg, Gs^Fms, Gg, Gg, Gg, Gg^Fms, Gg^Fms, Gll^Fp, Gg^Fms, Gg^Fp, Hh^Fp, Hh^Fms, Hh^Fp, Hh, Hh, Hh, Hh, Hh, Hh, Gll^Fp, Hh, Hh, Hh, Hh, Mm
Gs^Ft, Gs^Ft, Ss, Ss, Ss, Ss, Ss, Ss^Vhs, Ss, Ss, Ss, Rb, Gg^Em, Gg^Em, Rb, Rb, Rb, Gg^Ve, Rb, Gg, Ss, 3 Ktys, Ctys, Ctys, Ss, Gg, Ss, Gs^Fds, Ss, Gg, Gg, Gs^Fms, Gs^Fms, Gg, Gg, Gg, Gg^Fms, Gg^Fms, Gg^Fms, Gg^Fms, Gg^Fms, Gll^Fp, Gll^Fp, Hh^Fms, Hh^Fp, Hh^Fms, Hh, Hh, Hh, Hh^Fp, Hh^Fp, Hh, Hh^Fp, Gll^Fp, Gll, Hh, Hh, Hh
Ss, Ss, Ss, Ss, Ss, Ss, Gg, Ss, Gg, Ss, Gg, Rb, Gs^Fds, Gg^Em, Rb^Em, Rb, Rb, Rb, Rb, Rb, Rb, Ss, Ctys, Ctys, Ss, Ss, Ss, Ss, Ss, Ss, Ss, Gll^Fp, Gll^Fp, Gs^Fms, Gg, Gg, Gg, Gg^Fms, Gg, Gll^Fp, Gg^Fms, Gll^Fp, Gll^Fp, Hh^Fp, Hh, Hh, Hh, Hh, Hh, Hh, Hh, Hh^Fp, Gg^Fp, Gll^Fp, Gg, Hh, Hh, Gd
Ss, Ss, Ss, Gg, Gs^Fds, Gg, Gg, Gg, Ss, Ss, Ss, Rb^Em, Rb^Em, Rb^Em, Rb^Em, Rb^Em, Rb^Em, Rb^Em, Rb, Rb, Rb, Ss, Ss, Ss, Ss, Ss, Gg, Ss, Ss, Gs^Fms, Gs^Fms, Gg, Gs^Fms, Gll^Fp, Gll^Fp, Gg, Gg, Gg, Gg, Gll^Fp, Gll^Fp, Gll^Fp, Gg, Hh, Gll^Fp, Hh, Ch, 5 Kh, Ch, Hh, Hh, Hh, Gg, Gll^Fp, Gll^Fp, Gg, Gd, Gd
Gs^Fds, Gs^Fds, Gs^Fds, Gg, Gs^Fds, Gs^Fds, Gs^Fds, Ss, Ss, Gs^Fds, Gg, Gg, Gg, Gg, Rb, Rb, Ss, Rb, Rb, Rb, Rb, Rb^Em, Ss, Ss, Gs^Fms, Gg, Gg, Gg, Gg, Gs^Fms, Gs^Fms, Gll^Fp, Gll^Fp, Gll^Fp, Gg, Gg, Gg, Gg, Gg, Gg, Gg, Gg, Gg, Hh, Gg, Gg, Gg, Ch, Gg, Gg, Hh, Hh, Gg, Gg, Gs, Gg, Gd, Gd
Ss, Ss, Ss, Ss, Gs^Fds, Gg, Ss, Ss, Ss, Gs^Fds, Gs^Fds, Gs^Fds, Gs^Fds, Gs^Fds, Rb, Rb, Ss, Ss, Ss, Rb, Ss, Ss, Ss, Ss, Gg, Gs^Fms, Gs^Fms, Gg, Gg, Gs^Fms, Gll^Fp, Gg, Gg, Gg, Gg, Gg, Gs, Gs, Gs, Gg, Gs, Hh, Hh, Hh, Hh, Gg, Re, Re, Gs, Hh, Gg, Gg, Gs^Vc, Gg, Gs, Gs, Gd, Gd
Ss, Ss, Ss, Gs^Fds, Gs^Fds, Gs^Fds, Gs^Fds, Ss, Ss, Ss, Gs^Fds, Gs^Fds, Gs^Fds, Ss, Ss, Ss, Ss, Ss, Ss, Rb, Rb, Rb, Rb, Gg, Gs^Fms, Gs^Fms, Gs^Fms, Gg, Gll^Fp, Gll^Fp, Gll^Fp, Gll^Fp, Gg, Gg, Gg, Gg, Gg, Gs, Gg, Gg, Gs, Hh, Gs, Gll^Fp, Gg, Hh, Re, Gs, Gs, Hh, Gg, Gg, Gs, Gs, Gd, Gd, Dd, Dd
Gg, Gg, Gg, Ss, Gg, Gs^Fds, Gs^Fds, Gs^Fds, Gg, Ss, Ss, Gs^Fds, Ss, Ss, Ss, Rb, Rb, Rb, Rb, Rb, Rb, Rb, Rb, Gll^Fp, Gs^Fms, Gs^Fms, Gll^Fp, Gg, Gg, Gll^Fp, Gll^Fp, Gg, Gg^Eff, Gg^Eff, Gg^Eff, Gg, Gg, Gg, Gs, Gg, Gg, Gs, Gs^Vh, Gg, Gg, Gg, Re, Gg, Gg, Gg, Gs, Gs, Re, Re, Gd, Re, Dd, Dd
Gs^Fds, Gg, Gg, Gg, Gg, Gg, Gg, Gg, Ss, Ss, Gg, Ss, Gg, Gg, Gg, Gg^Ve, Rb, Rb, Rb, Rb, Rb, Rb, Rb, Gll^Fp, Gll^Fp, Gll^Fp, Gs^Fms, Gll^Fp, Gg, Gg, Gg^Eff, Gg^Eff, Rb^Gvs, Rb^Gvs, Rb^Gvs, Gg^Eff, Gg^Eff, Gg, Gg, Gg, Gs, Gs, Re, Re, Re, Re, Re, Gg, Gg^Fmw, Gg, Gd, Gs, Gd, Re, Rd, Dd, Dd, Rb
Gs^Fds, Gs^Fds, Gs^Fds, Gs^Fds, Gs^Fds, Gg, Gg, Gg, Ss, Gg, Gg, Gs^Fds, Gs^Fds, Gs^Fds, Gs^Fds, Gg, Rb, Rb, Rb, Rb, Rb, Rb, Rb, Rb, Rb, Gll^Fp, Gll^Fp, Gll^Fp, Gg, Gg^Eff, Rb^Gvs, Rb^Gvs, Rb^Gvs, Rb^Gvs, Rb^Gvs, Rb^Gvs, Rb^Gvs, Gg^Eff, Rb^Eff, Gs, Gd, Gs, Gs, Gs, Re, Re, Re, Gg, Gg, Gg, Gd, Rd, Gd, Rd, Dd, Dd, Uu, Uu
Gs^Fds, Gs^Fds, Gs^Fds, Gs^Fds, Gs^Fds, Gg, Ss, Gg, Ss, Gg, Gg, Gg, Gg, Gs^Fds, Gs^Fds, Gs^Fms, Gs^Fms, Rb, Rb, Rb, Rb, Rb, Rb, Rb, Rb, Gll^Fp, Rb, Rb, Gg, Rb^Gvs, Rb^Gvs, Rb^Gvs, Rb^Gvs, Rb^Gvs, Rb^Gvs, Rb^Gvs, Rb, Rb, Gd, Gd^Eff, Gd^Eff, Gd, Re, Re, Re, Re, Re, Gd, Gd^Fmw, Gd^Fmw, Gd, Rd, Dd, Dd, Ydb, Ydb^Es, Uu, Uu
Gs^Fds, Gs^Fds, Gs^Fds, Gs^Fds, Gs^Fds, Ss, Ss, Ss, Ss, Ss, Gg, Gg, Gs^Fds, Gs^Fds, Gs^Fms, Gs^Fms, Gs^Fms, Gs^Fms, Gg, Gg, Rb, Rb, Rb, Rb, Rb, Rb, Rb, Rb, Rb, Gg, Rb, Rb^Gvs, Rb^Gvs, Rb^Gvs, Re, Rb, Re, Re, Gd, Gd, Gd, Gd^Eff, Gd, Gd, Re, Re, Re, Gd, Rd, Gd, Rd, Dd, Dd, Ydb^Es, Ydb, Ydb, Ydb, Uu
Gs^Fds, Gs^Fds, Gs^Fds, Gs^Fds, Gs^Fds, Gg, Gg, Gg, Gg, Gg, Gg, Gg, Gs^Fms, Gs^Fds, Gs^Fds, Gs^Fms, Gs^Fms, Gs^Fms, Rb, Rb, Rb, Gg, Gg, Rb, Gg, Rb, Rb, Rb, Rb, Rb, Rb, Rb, Re, Re, Rp, Rp, Rp, Rp, Rr, Gd, Rd, Gd, Dd, Rd, Rd, Rd, Rd, Rd, Rd, Rd, Dd, Dd, Dd, Ydb^Es, Ydb, Ydb, Ydb, Ydb
Gs^Fms, Gs^Fms, Gs^Fms, Gs^Fms, Gs^Fms, Gs^Fms, Gg, Gg, Gs^Fms, Gs^Fms, Gs^Fms, Gs^Fms, Gs^Fms, Gs^Fds, Gll^Fp, Gs^Fds, Gs^Fms, Gs^Fms, Gg, Rb, Gg, Gg, Gg, Gg, Gg, Gg, Rb, Rb, Rb, Rb, Rb, Re, Re, Rp, Rr, Rr, Ce, Rr, Rr^Vwm, Rr, Dd, Dd, Dd, Dd, Dd, Dd, Dd, Dd, Dd, Dd, Dd, Dd, Ydb, Ydb, Ydb, Ydb, Wwby, Wwby
Gs^Fms, Gs^Fms, Gs^Fms, Gll^Fp, Gg, Gg, Gg, Gg, 2 Kty, Gs^Fms, Gll^Fp, Gll^Fp, Gg, Gll^Fp, Gll^Fp, Gll^Fp, Gll^Fp, Gg, Gg, Re, Gg, Gg, Gs, Gg, Rb, Rb, Gg, Rb, Gs, Re, Re, Re, Rp, Rr, Rr, Ce, 4 Ket, Rr, Rr, Rr, Dd, Ydb^Es, Ydb^Es, Ydb^Es, Ydb, Dd^Es, Ydb, Ydb^Es, Ydb, Ydb^Es, Ydb, Ydb, Ydb, Ydb, Ydb, Ydb, Wwby, Wwby
Gs^Fms, Gs^Fms, Gll^Fp, Gll^Fp, Gg, Gg, Gg, Cty, Cty, Cty, Gg, Gg, Gg, Gg, Gg, Gll^Fp, Gg, Gll^Fp, Gg, Re, Re, Gs, Gg, Gg, Rb, Gg, Gs, Gs, Gs, Re, Re, Rp, Rr, Rr, Rr, Rr, Ce, Ce, Rr, Rr, Rd, Ydb^Es, Urb, Ydb, Ydb, Ydb^Es, Ydb, Ydb, Ydb, Ydb^Fdy, Ydb^Fdy, Ydb^Fdy, Ydb^Fdy, Ydb, Wwby, Wwby, Woby, Woby
Gg, Gg, Gg, Gll^Fp, Gll^Fp, Gs^Fms, Gll^Fp, Gg, Gg, Re, Gg, Gg^Lyr\, Gg^Lyr\, Gg, Gg, Gg, Gs, Gs, Gs, Gd, Gd, Re, Re, Rb, Gg, Gg, Gs, Gs, Gs, Gs, Re, Rp, Rp, Rr^Vh, Rp, Rr, Rr, Rr, Rr, Rd, Uu, Uu, Uu, Urb, Urb, Ydb, Ydb^Vhcr, Ydb, Ydb, Ydb^Fdy, Ydb, Ydb^Fdy, Wwby, Wwby, Wwby, Wwby, Woby, Woby
Gg, Gg, Gg, Gg, Gg, Gll^Fp, Gg, Gg, Gg, Re, Re, Gg, Gg, Gg^Lyr\, Gg, Gs, Gs, Gs, Gs, Gs, Gs, Gd, Re, Rb, Gg, Gg, Gg, Gs, Gg, Gs, Re, Re, Rd, Rd, Rd, Rd, Dd, Rd, Uu, Urb, Urb, Uu, Urb, Urb, Urb, Urb, Uu, Ydb, Ydb, Ydb, Ydb, Wwby, Wwby, Wwby, Wwby, Wwby, Woby, Woby
Gg, Gg, Gll^Fp, Gll^Fp, Gs^Fms, Gg, Gll^Fp, Gg, Gg, Gg, Re, Gg, Gg, Gg, Gs^Vc, Gg, Gg, Gs, Gs, Gd, Gs, Gs, Re, Re, Gd, Gg, Gg, Gs, Gg, Gg, Gg, Rd, Dd, Dd, Dd, Rd, Dd, Ydb, Ydb, Uu, Urb, Urb, Uu, Uu, Urb, Urb, Urb, Urb, Urb^Bsb\, Ydb, Wwby, Wwby, Wwby, Wwby, Woby, Woby, Woby, Woby
Gs, Gg, Gg, Gs^Fms, Gg, Gll^Fp, Gg, Gg, Gs, Gs, Re, Gs, Re, Re, Re, Gg, Gg, Gg, Re, Re, Re, Re, Gd, Re, Re, Gg, Gg, Gg, Gd, Gd, Gd, Dd, Ydb^Es, Ydb^Es, Ydb^Es, Dd, Ydb^Es, Ydb, Ydb, Ydb, Urb, Urb, Urb, Uu, Uu, Urb, Urb, Urb, Ydb, Wwby^Bsb\, Wwby, Wwby, Wwby, Woby, Woby, Woby, Wwby, Woby
Gs, Gs, Gg, Gg, Gg, Gg, Gs, Gs, Gg, Gs, Re, Re, Gg, Gg, Gg, Re, Re, Re, Gs, Gs, Gg, Gs, Gg, Re, Rd, Rd, Gd, Gd, Gd, Gd, Gd^Es, Dd, Ydb, Ydb, Ydb, Ydb, Ydb, Ydb, Ydb, Uu, Uu, Uu, Uu, Uu, Uu, Urb, Ydb, Ydb, Wwby, Wwby, Wwby, Wwby, Wwby, Woby, Woby, Woby, Wwby, Wwby
Gs, Gs, Gg, Gg, Gs, Gg, Re, Gs^Vc, Gg, Re, Gs, Gs, Gs, Gs, Gs, Gg, Gg, Gg, Gg, Gs, Gg^Fmw, Gg, Gg, Gg, Gd, Rd, Rd, Rd, Gd, Gd, Dd, Dd, Ydb, Ydb, Ydb, Ydb, Ydb, Ydb, Ydb, Uu, Ydb, Uu, Ydb, Uu, Ydb, Ydb, Ydb, Wwby, Wwby, Wwby, Wwby, Wwby, Wwby, Woby, Wwby, Wwby, Wwby, Wwby
Gg, Gg, Gg, Gg, Gg, Gg, Gs, Re, Gg, Gg, Gs, Gs, Gg, Gg, Gs, Gg, Gs, Gg, Gd, Gg, Gs^Fmw, Gg^Fmw, Gs, Gd, Gd, Gd, Dd, Rd, Dd, Dd, Ydb, Ydb^Es, Ydb, Ydb, Ydb^Fdy, Ydb^Fdy, Ydb^Fdy, Ydb, Ydb, Ydb, Ydb, Ydb, Ydb, Ydb, Ydb, Ydb, Wwby, Wwby, Woby, Woby, Woby, Wwby, Woby, Woby, Wwby, Wwby, Ydb, Wwby
Gg, Gg, Gg, Gg, Gg, Gs, Gs, Gg, Gg, Gg, Gs, Gs, Gg^Fmw, Gs^Fmw, Gs^Fmw, Gs, Gd, Gd, Gd, Gd, Gd, Gd, Gs, Gd, Gd^Es, Dd, Ydb^Es, Rd, Urb, Ydb^Es, Uu, Ydb, Ydb^Fdy, Ydb, Ydb^Fdy, Ydb^Fdy, Ydb, Ydb, Ydb, Ydb, Ydb, Ydb, Ydb, Ydb, Wrby, Wrby, Wrby, Wrby, Wrby, Woby, Wrby, Woby, Woby, Woby^Bsb\, Woby^Bsb\, Ydb, Urb, Ydb
Gg, Gg, Gs^Fmw, Gs^Fmw, Gs^Fmw, Gs, Gs^Fmw, Gg, Gd, Gd, Gd, Gd, Gd, Gd, Gd, Gd, Gd, Gd, Dd, Gd, Dd, Gd, Gs, Gd, Dd, Dd, Ydb, Uu, Uu, Urb, Urb, Uu, Uu, Ydb^Fdy, Ydb^Fdy, Ydb, Ydb, Ydb, Ydb, Ydb, Wwby, Wwby, Woby, Woby, Wwby, Wwby, Wwby, Wrby, Ydb, Wrby, Wrby, Woby, Woby, Wwby, Wwby, Urb^Bsb\, Urb, Urb
Gs^Fmw, Gg, Gg, Gg, Gs, Gs^Fmw, Gd, Gd, Gd, Gd, Gd, Gd, Gd, Gd, Gd, Gd, Dd, Dd, Dd, Dd, Dd, Gd, Gd, Gd, Dd, Ydb^Es, Ydb, Ydb, Ydb^Fdy, Ydb, Ydb, Urb, Uu, Ydb^Fdy, Ydb, Ydb, Ydb^Vhcr, Ydb, Ydb, Wwby, Wwby, Wwby, Woby, Woby, Wwby, Wwby, Ydb, Ydb, Uh, Ydb, Wrby, Wrby, Woby, Wwby, Urb, Urb, Urb, Urb
Gs^Fmw, Gg, Gs^Fmw, Gs^Fmw, Gd, Gd, Gd, Gd, Gd, Gd, Dd, Dd, Dd, Gd, Dd, Dd, Ydb^Es, Dd, Dd, Dd, Dd, Gd, Dd, Gd, Dd, Ydb, Ydb, Ydb^Fdy, Ydb^Fdy, Wwby, Wwby, Ydb, Uu, Urb, Urb, Ydb, Ydb, Ydb, Wwby, Wwby, Wwby, Wwby, Woby, Woby, Wwby, Ydb, Uh, Uu, Uh, Ydb, Wwby, Wrby, Wwby, Wwby, Wwby, Urb, Urb, Urb
Gs^Fmw, Gs^Fmw, Gd, Gd, Gd, Gd, Gd, Gd, Dd, Dd, Dd, Dd^Es, Dd, Dd, Dd, Dd, Ydb, Ydb, Ydb, Ydb^Es, Ydb, Dd, Dd, Dd, Ydb, Ydb, Ydb, Ydb^Fdy, Ydb^Fdy, Ydb^Fdy, Wwby, Ydb^Es, Ydb, Uu, Urb, Ydb, Woby, Woby, Woby, Wwby, Wwby, Wwby, Wwby, Wwby, Wwby, Ydb, Woby, Uu, Wwby, Ydb, Wwby, Wrby, Wrby, Wwby, Wwby, Urb, Urb, Urb
Gd, Gs^Fmw, Gd, Gd, Dd, Gd, Dd, Dd, Dd^Es, Dd, Dd, Dd, Dd, Dd, Ydb, Ydb, Ydb^Es, Ydb, Ydb, Ydb, Ydb, Ydb, Ydb, Ydb, Ydb, Ydb, Ydb, Ydb, Ydb, Wwby, Wwby, Ydb, Ydb, Ydb, Ydb, Ydb^Bsb\, Woby^Bsb\, Woby, Woby, Wrby, Wrby, Wwby, Woby, Woby, Woby, Wwby, Woby, Woby, Woby, Wwby, Wwby, Wrby, Wwby, Wrby, Ydb, Uu, Uu, Urb
Gd, Gd, Dd, Dd, Dd^Es, Dd, Dd, Dd, Dd, Dd, Dd, Uu, Uu, Ydb, Ydb, Ydb, Ydb, Ydb, Ydb, Ydb, Ydb, Ydb, Ydb, Ydb, Uu, Ydb, Uu, Ydb, Uu, Ydb, Wwby, Wwby, Wrby, Ydb, Wrby, Wrby, Wrby, Wwby, Wwby, Wrby, Wwby, Wwby, Wrby, Woby, Woby, Woby, Woby, Woby, Woby, Woby, Woby, Wrby, Wrby, Wwby, Ydb, Ydb, Uu, Uu
Gd, Gd, Dd, Dd, Dd, Dd, Dd, Dd, Dby^Es, Dby, Uu^Fdy, Uu, Uu, Uu, Ydb, Ydb, Ydb, Ydb^Es, Ydb, Ydb, Ydb, Ydb, Uu, Uu, Woby, Uu, Wwby, Uu, Wwby, Uu, Wwby, Wrby, Wrby, Wrby, Wrby, Wrby, Wrby, Wrby, Wwby, Wwby, Wwby, Wwby, Wwby, Wwby, Woby, Woby, Woby, Woby, Woby, Woby, Woby, Wrby, Uu, Ydb, Ydb^Fdy, Ydb^Fdy, Ydb^Fdy, Uu
Dd, Dd, Dd, Dd, Dd, Dd, Dby^Es, Dby, Dby, Dby, Uu, Uu^Fdy, Uu, Uu, Uu, Ydb, Ydb, Ydb, Uu, Ydb, Uu, Uu, Woby, Woby, Woby, Wwby, Wrby, Wwby, Wrby, Wwby, Wrby, Wrby, Wrby, Wrby, Wrby, Wwby, Wwby, Wrby, Wrby, Woby, Woby, Woby, Woby, Wwby, Woby, Woby, Woby, Woby, Woby, Woby, Woby, Woby, Uu, Ydb, Ydb, Ydb^Fdy, Ydb^Fdy, Ydb^Fdy
Dd, Dd, Uu, Dby^Es, Dby, Dby, Dby, Dby, Dby, Dby, Uu, Uu^Fdy, Uu, Uu^Vhcr, Uu, Ydb, Uu, Ydb, Uu, Uu, Uu, Woby, Woby, Woby, Woby, Wwby, Wrby, Wrby, Wwby, Wrby, Wrby, Wwby, Wwby, Wwby, Wwby, Wwby, Wrby, Wrby, Woby^Bsb\, Woby, Woby, Woby, Woby, Woby, Woby, Woby, Woby, Woby, Woby, Woby, Woby, Woby, Uu, Uu, Uu, Uu, Uh, Uh
Uu, Uu, Uu, Dby, Dby, Dby, Dby, Dby, Dby, Uu, Uu, Uu, Uu, Uu, Uu, Uu, Uu, Uu, Uu, Uu, Uu, Wwby, Woby, Woby, Wrby, Wwby, Wwby, Wwby, Wwby, Wwby, Wrby, Wwby, Wrby, Wwby, Wwby, Wwby, Wwby, Wrby, Wwby, Woby^Bsb\, Urb, Urb, Urb, Woby, Urb^Shyd, Woby, Woby, Woby, Woby, Woby, Woby, Uu, Ydb, Uu, Uu, Uu, Ydb, Ydb
Uu, Uu, Uu, Uu, Uu, Uu, Uu, Dby, Dby, Uu, Uu, Uu, Uu, Uu, Uu, Uu, Uu, Uu, Uu, Uu, Wwby, Wwby, Wrby, Wrby, Wwby, Wwby, Woby, Woby, Wwby, Wrby, Wrby, Wwby, Wwby, Wwby, Wwby, Wwby, Woby, Woby, Urb, Urb, Uu, Urb, Uu, Urb, Urb, Uu, Uu, Wwby, Wrby, Woby, Woby, Ydb, Wwby, Ydb, Ydb, Uu, Ydb, Ydb
Uu, Uu, Uu, Uu^Fdy, Uu^Fdy, Uu, Uu^Fdy, Uu, Uu^Fdy, Uu^Fdy, Uu^Fdy, Uu^Fdy, Uu, Uu, Uu, Uu, Uu, Uu, Uu, Uu, Woby, Wwby, Wwby, Wrby, Wwby, Woby, Woby, Woby, Woby, Wwby, Wrby, Wrby, Wrby, Woby, Woby, Woby, Woby, Woby, Ydb, Uu, Uu, Uu, Ydb^Fyok, Uu, Urb, Urb, Uu, Ydb, Ydb, Wwby, Wwby, Wwby, Wrby, Wwby, Ydb, Ydb, Ydb, Ydb
Uu, Uu, Uu, Uu, Uu^Fdy, Uu, Uu, Uu, Uu^Fdy, Uu^Fdy, Uu, Uu, Uu, Uu, Uu, Uu, Uu, Uu, Ydb, Woby, Woby, Woby, Wwby, Wwby, Wwby, Woby, Woby, Woby, Woby, Woby, Wwby, Wwby, Wwby, Wrby, Ydb, Ydb, Ydb, Woby, Ydb, Ydb, Ydb, Ydb, Ydb, Uu, Uh, Urb, Urb, Ydb, Ydb, Ydb, Ydb, Wrby, Wwby, Ydb, Ydb, Ydb, Ydb, Ydb
Uu, Uu, Uu, Uu, Uu, Uu, Uu, Uu, Uu, Uu^Fdy, Uu, Uu, Uu, Uu, Uu, Uu, Uu, Uu, Woby, Woby, Wwby, Wwby, Wwby, Wwby, Wwby, Wwby, Woby, Woby, Woby, Woby, Woby, Woby, Ydb, Ydb, Ydb, Ydb, Ydb, Ydb, Ydb, Ydb, Ydb, Ydb^Fdy, Uh, Uh, Uh, Uh, Ydb, Urb, Ydb, Ydb, Ydb, Ydb, Ydb, Ydb, Ydb, Ydb, Ydb, Ydb
Uu, Uu, Uu, Uu, Uu, Uu, Uu, Uu, Uu, Uu, Uu, Uu, Uu, Uu, Ydb, Woby, Woby, Woby, Woby, Wwby, Wwby, Wwby, Wwby, Wwby, Wwby, Wwby, Woby, Woby, Woby, Woby, Woby, Ydb, Ydb, Ydb, Ydb, Ydb, Ydb, Ydb, Ydb, Ydb, Ydb, Ydb, Ydb, Ydb, Ydb, Ydb, Ydb, Ydb, Ydb, Ydb, Ydb, Ydb, Ydb, Ydb, Ydb, Ydb, Ydb, Ydb
