Qxu, Qxu, Qxu, Qxu, Qxu, Qxu, Qxu, Qxu, Qxu, Qxu, Qxu, Qxu, Qxu, Qxu, Qxu, Qxu, Qxu, Qxu, Qxu, Qxu, Qxu, Qxu, Qxu, Qxu, Qxu, Qxu, Qxu
Qxu, Qxu, Qxu, Qxu, Qxu, Qxu, Qxu, Qxu, Qxu, Qxu, Qxu, Qxu, Qxu, Qxu, Qxu, Qxu, Qxu, Qxu, Qxu, Qxu, Qxu, Qxu, Qxu, Qxu, Qxu, Qxu, Qxu
Qxu, Qxu, Qxu, Qxu, Qxu, Qxu, Qxu, Qxu, Qxu, Qxu, Qxu, Qxu, Qxu, Qxu, Qxu, Qxu, Qxu, Qxu, Qxu, Qxu, Qxu, Qxu, Qxu, Qxu, Qxu, Qxu, Qxu
Qxu, Qxu, Qxu, Qxu, Qxu, Qxu, Qxu, Qxu, Qxu, Qxu, Qxu, Qxu, Qxu, Qxu, Qxu, Qxu, Qxu, Qxu, Qxu, Qxu, Qxu, Qxu, Qxu, Qxu, Qxu, Qxu, Qxu
Qxu, Qxu, Qxu, Qxu, Qxu, Qxu, Qxu, Qxu, Qxu, Qxu, Qxu, Qxu, Qxu, Qxu, Qxu, Qxu, Qxu, Qxu, Qxu, Qxu, Qxu, Qxu, Qxu, Qxu, Qxu, Qxu, Qxu
Qxu, Qxu, Qxu, Qxu, Qxu, Qxu, Qxu, Qxu, Uh, Qxu, Qxu, Qxu, Qxu, Qxu, Qxu, Qxu, Qxu, Qxu, Qxu, Qxu, Qxu, Qxu, Qxu, Qxu, Qxu, Qxu, Qxu
Qxu, Qxu, Qxu, Qxu, Qxu, Qxu, Uh, Uh, Cmy, Cmy, Cmy, Uh, Uh, Qxu, Uu, Qxu, Qxu, Qxu, Qxu, Qxu, Qxu, Qxu, Qxu, Qxu, Qxu, Qxu, Qxu
Qxu, Qxu, Qxu, Qxu, Qxu, Qxu, Uh, Uu, Cmy, 4 Kmy, Cmy, Rrc, Rrc, Uu, Uu, Uu, Cmy, Qxu, Qxu, Qxu, Qxu, Qxu, Qxu, Qxu, Qxu, Qxu, Qxu
Qxu, Qxu, Qxu, Qxu, Qxu, Qxu, Uu, Uu, Rrc, Cmy, Rrc, Ymnv, Rrc, Uu, Uu, Uu, Uu, Qxu, Qxu, Qxu, Qxu, Qxu, Qxu, Qxu, Qxu, Qxu, Qxu
Qxu, Qxu, Qxu, Qxu, Qxu, Uh, Uu, Rr, Rrc, Rrc, Rr, Rrc, Uu, Uu, Uu, Uu, Uu, Qxu, Qxu, Qxu, Qxu, Qxu, Qxu, Qxu, Qxu, Qxu, Qxu
Qxu, Qxu, Qxu, Qxu, Qxu, Uh, Uu, Rr, Rr, Rrc, Uu, Uu, Uu, Uu, Uu, Uu, Uu, Uu, Qxu, Qxu, Qxu, Qxu, Qxu, Qxu, Qxu, Qxu, Xu
Qxu, Qxu, Qxu, Qxu, Qxu, Uh, Uu, Uu, Uu, Rr, Uu, Uu, Uu, Uu, Uu, Uu, Uh, Uu, Uu, Qxu, Qxu, Qxu, Uu, Qxu, Rb, Xu, Xu
Xu, Qxu, Uh, Qxu, Uh, Uh, Uu, Uu, Uu, Rr, Rr, Uu, Uu, Uu, Uu, Uu, Ql, Uh, Uh, Uu, Uh, Uh, Uu, Rb, Uu, Xu, Xu
Xu, Xu, Uu, Uh, Ql, Uu, Uu, Uu, Uu, Uu, Uu, Rr, Uu, Uu, Uu, Uu, Uu, Uh, Uh, Uh, Ql, Uh, Uu, Uu^Vu, Uu, Xu, Xu
Xu, Xu, Uu, Ql, Uu, Uu, Uu, Uu, Uu, Uu, Uu, Rr, Rr, Uu, Uu, Uu, Uu, Ql, Uu, Uh, Uu, Uu, Rb, Rb, Uu, Xu, Xu
Xu, Xu, Uu, Rb, Rb, Uu^Vu, Uu, Uu, Uu, Uu, Uu, Rr, Rr, Uu, Uu, Uu, Uu, Uu, Rb, Uu, Rb, Rb, Xoym, Uu, Xoym, Xoym, Xoym
Xoym, Xoym, Uu, Uu, Uu, Rb, Rb, Uu, Uu, Uu, Rr, Rr, Rr, Rr, Rr, Uu, Rb, Rb, Uu, Rb, Xoym, Xoym, Xoym, Xoym, Xoym, Xoym, Xoym
Xoym, Xoym, Xoym, Uu, Uu, Uu, Uu, Rb, Uu, Rr, Uu, Rr, Rr, Uu, Uu, Rb, Xoym, Xoym, Xoym, Xoym, Xoym, Xoym, Xoym, Xoym, Xoym, Xoym, Xoym
Xoym, Xoym, Xoym, Xoym, Xoym, Xoym, Xoym, Uu, Xoym, Uu, Uu, Rr, Cmy, Rr, Xoym, Xoym, Xoym, Xoym, Rrc, Xoym, Rrc, Rrc, Rrc, Rrc, Xoym, Xoym, Xoym
Xoym, Xoym, Brym, Brym, Brym, Xoym, Xoym, Xoym, Xoym, Xoym, Xoym, Brym, Brym, Brym, Brym, Xoym, Rrc, Rrc, Rrc, Rrc, Rrc, Rrc, Rrc, Rrc, Xoym, Xoym, Xoym
Xoym, Xoym, Brym, Brym^Vymb, Brym, Brym, Xoym, Xoym, Rrc, Xoym, Brym, Brym, Brym, Brym, Brym^Bryl, Brym, Rrc, Xoym, Xoym, Rrc, Xoym, Rrc, Xoym, Xoym, Xoym, Xoym, Xoym
Xoym, Xoym, Rrc, Brym, Rrc, Rrc, Rrc, Rrc, Rrc, Rrc, Xoym, Xoym, Brym, Brym, Brym, Brym, Brym, Rrc, Xoym, Xoym, Xoym, Xoym, Xoym, Xoym, Xoym, Xoym, Xoym
Xoym, Xoym, Rrc, Rrc, Rrc, Rrc, Rrc, Rrc, Rrc, Xoym, Xoym, Brym, Brym, Brym, Xoym, Brym, Xoym, Xoym, Xoym, Xoym, Xoym, Xoym, Xoym, Xoym, Xoym, Xoym, Xoym
Xoym, Xoym, Rrc, Rrc, Rrc, Rrc, Xoym, Xoym, Xoym, Xoym, Brym, Xoym, Brym, Xoym, Brym, Brym, Brym, Brym, Brym, Xoym, Xoym, Xoym, Xoym, Xoym, Xoym, Xoym, Xoym
Xoym, Xoym, Rrc, Rrc, Xoym, Xoym, Brym, Xoym, Brym, Brym, Brym, Brym, Brym, Brym, Brym, Brym, Brym, Brym^Vymb, Brym, Brym, Xoym, Xoym, Brym, Xoym, Xoym, Xoym, Xoym
Xoym, Xoym, Xoym, Xoym, Xoym, Xoym, Brym, Brym, Brym, Brym, Brym, Brym, Brym, Brym, Brym, Brym, Brym, Brym, Brym, Brym, Xoym, Brym, Brym, Brym, Brym, Xoym, Xoym
Xoym, Xoym, Xoym, Xoym, Brym, Xoym, Brym, Brym, Brym^Lyml, Brym, Brym, Brym, Cmy, Cmy, Cmy, Brym, Brym, Brym, Xoym, Xoym, Brym, Brym, Brym, Brym, Brym, Xoym, Xoym
Xoym, Xoym, Xoym, Brym, Brym, Brym, Brym, Xoym, Rrc^Lymp, Brym^Lyml, Brym, Brym, Cmy, 1 Kmy, Cmy, Brym, Brym, Brym, Brym, Xoym, Brym, Brym, Brym, Brym, Brym, Xoym, Xoym
Xoym, Xoym, Xoym, Brym, Brym, Brym, Brym, Xoym, Brym^Lyml, Brym^Lyml, Brym, Brym, Brym, Cmy, Brym, Brym, Brym, Brym, Brym, Brym, Xoym, Xoym, Brym, Brym, Xoym, Xoym, Xoym
Xoym, Xoym, Xoym, Brym, Brym, Brym, Xoym, Xoym, Brym, Brym, Brym^Vymb, Brym, Brym, Brym, Brym, Brym, Brym, Brym, Brym, Xoym, Xoym, Brym, Brym, Brym, Xoym, Xoym, Xoym
Xoym, Xoym, Xoym, Brym, Xoym, Xoym, Brym, Brym, Brym, Brym, Brym, Brym, Brym, Brym, Brym, Brym, Xoym, Brym, Brym, Xoym, Xoym, Brym, Xoc, Xoc, Rr, Xoc, Xoc
Xoym, Xoym, Xoym, Xoym, Brym, Brym, Brym, Brym, Brym, Brym, Xoym, Brym, Brym^Bryl, Brym, Brym^Bryl, Brym, Brym, Xoym, Brym, Brym, Rrc, Xoym, Xoc, Rr, Rr, Rr, Xoc
Xoym, Xoym, Xoym, Xoym, Brym, Brym, Brym^Vymb, Brym, Brym, Xoym, Brym, Brym, Brym, Brym, Brym, Brym, Brym, Brym, Rrc, Rrc, Rrc^Pr/, Xoc, Xoc, Rr, Rr, Rr, Xoc
Xoym, Xoym, Xoym, Xoym, Brym, Brym, Brym, Brym, Brym, Brym, Brym, Brym, Brym, Brym, Brym, Brym, Rrc, Rrc, Rrc^Pr/, Rrc^Pr/, Rd, Rd, Rr, Rr, Xoc, Xoc, Xu
Xoym, Xoym, Xoym, Xoym, Brym, Brym, Brym, Brym, Brym, Brym, Brym, Brym, Xoym, Brym, Xoym, Xoym, Xoc, Rrc^Pr/, Rd, Rd, Ds, Ds, Ds, Rr, Rr, Xoc, Xu
Xoym, Xoym, Xoym, Xoym, Xoym, Brym, Brym, Brym, Xoym, Brym, Xoym, Xoym, Xoym, Xoym, Xoym, Xoc, Rr, Rd, Ds, Ds, Dd, Ds, Ds, Rr, Xoc, Xoc, Xu
Xoym, Xoym, Xoym, Xoym, Xoym, Xoym, Xoym, Xoym, Xoym, Xoym, Xoym, Xoym, Xoym, Xoym, Xoc, Xoc, Rr, Rd, Ds, Ds, Ds, Ds^Dr, Ds, Rr, Xoc, Xoc, Xu
Xoym, Xoym, Xoym, Xoym, Urfz, Xoym, Xoym, Xoym, Xoym, Xoym, Xoc, Xoc, Rr, Xoc, Rr, Rr, Dd^Dr, Ds, Dd, Dd, Ds, Ds, Ds, Rr, Xoc, Xoc, Xu
Xoym, Xoym, Urfz, Urfz, Urfz, Urfz, Urfz, Xoym, Xoc, Xoc, Rr, Rr, Rd, Rr, Ds, Ds, Dd, Dd, Dd, Dd, Dd, Dd, Ds, Rr, Rr, Xoc, Xu
Xoym, Urfz, Urfz, Urfz, Urfz, Urfz, Xoym, Xoc, Rr, Rr, Rd, Rd, Ds, Ds, Ds, Ds, Dd, Ds, Dd, Dd, Dd, Ds, Ds, Ds, Rr, Xoc, Xu
Xoym, Xoym, Rrc, Urfz, Xoym, Xoym, Xoym, Xoc, Rr, Rr, Rd, Rd, Rd^Qov, Ds, Ds, Ds, Ds, Ds, Dd, Dd, Dd, Dd, Ds, Ds, Rr, Xoc, Xu
Xoym, Xoym, Rrc^Pr/, Xoym, Brym, Xoym, Xoym, Xoym, Rrc, Rr, Rrc, Rd, Ds, Ds, Ds, Ds, Ds, Ds^Dr, Dd, Dd, Ds, Ds, Ds, Ds, Rd, Xoc, Xu
Xoym, Xoym, Xoym, Brym, Brym^Vymb, Brym, Rrc, Rrc^Pr\, Rrc^Pr\, Rrc, Rrc, Rrc, Ds, Ds, Dd, Dd, Dd, Ds, Ds, Ds, Ds, Ds^Dr, Ds, Ds, Rd, Xoc, Xu
Xoym, Xoym, Xoym, Brym, Brym, Brym, Brym, Rrc, Rrc, Rrc^Pr\, Xoym, Rrc, Rrc, Ds, Ds, Dd, Ds, Ds, Ds, Ds, Ds, Ds, Rd^Vu, Rd, Xoc, Xoc, Xu
Xoym, Xoym, Xoym, Rrc, Brym, Brym, Rrc, Rrc, Xoym, Xoym, Rr, Rr, Rd^Qov, Ds, Ds^Dr, Ds, Ds, Ds, Rr, Rd, Rd, Rd, Rd, Rd, Xoc, Xoc, Xos
Xoym, Xoym, Xoym, Rrc, Brym, Brym, Rrc, Xoym, Xoym, Xoym, Xoc, Rr, Rd, Ds, Ds, Ds, Rr, Rr, Xoc, Rr, Xoc, Xoc, Xoc, Xoc, Xos, Xos, Xos
Xoym, Xoym, Rrc^Bryl, Rrc, Brym, Brym, Brym, Xoym, Xoym, Xoym, Xoc, Rr, Ds, Ds, Rr, Rd, Xoc, Xoc, Xoc, Xoc, Xos, Xos, Xos, Xos, Xos, Xos, Xos
Xoym, Xoym, Xoym, Rrc, Brym, Brym, Brym, Brym^Vymb, Xoym, Xoym, Xoc, Rr, Rr, Rd, Xoc, Xoc, Xos, Xos, Xos, Xos, Xos, Xos, Xos, Xos, Brym^Vymb, Xos, Xos
Xoym, Xoym, Xoym, Rrc, Brym, Brym, Brym, Brym, Xoym, Xoym, Xoc, Rr, Xoc, Xoc, Xos, Xoc, Xos, Xos, Xos, Xos, Urfz, Xos, Urfz, Brym, Brym, Xos, Xos
Xoym, Xoym, Rrc^Bryl, Rrc, Brym, Brym, Rrc, Xoym, Xoym, Xoym, Xoym, Xoc, Xos, Xos, Xos, Xos, Urfz, Xos, Urfz, Urfz, Urfz, Urfz, Urfz, Urfz, Urfz, Xos, Xos
Xoym, Xoym, Xoym, Rrc, Brym, Brym, Rrc, Xoym, Xoym, Xoym, Xoym, Xoym, Xoym, Xos, Xos, Urfz, Urfz, Urfz, Urfz, Urfz, Urfz, Urfz, Urfz, Urfz, Urfz, Xos, Xos
Xoym, Xoym, Xoym, Rrc, Brym, Brym, Cmy, Rrc, Xoym, Xoym, Xoym, Xoym, Xoym, Xoym, Xoym, Xos, Rrc^Pr\, Urfz, Urfz, Urfz, Urfz, Urfz, Urfz, Urfz, Urfz, Xos, Xos
Xoym, Xoym, Xoym, Rrc, Brym, 6 Kmy, Cmy, Brym, Brym, Rrc, Rrc, Rrc, Rrc, Xoym, Brym, Rrc, Brym, Xos, Xos, Urfz, Xos, Urfz, Urfz, Urfz, Urfz, Xos, Xos
Xoym, Xoym, Xoym, Rrc, Xoym, Brym, Brym, Cmy, Brym, Brym, Brym, Rrc, Brym, Brym, Brym, Brym, Xoym, Xos, Xos, Xos, Xos, Xos, Urfz, Urfz, Urfz, Xos, Xos
Xoym, Xoym, Xoym, Xoym, Rrc, Rrc, Rrc, Brym, Brym, Brym, Brym^Fynt, Brym, Brym, Brym, Brym, Brym, Xoym, Xoym, Xoym, Xos, Xos, Xos, Urfz, Urfz, Urfz, Xos, Xos
Xoym, Xoym, Xoym, Xoym, Rrc, Rrc, Rrc, Rrc, Rrc, Brym, Brym, Brym, Brym^Bryl, Brym, Brym, Xoym, Xu, Xoym, Xu, Xu, Xu, Xos, Xos, Xos, Xos, Xos, Xos
Xoym, Xoym, Xoym, Xoym, Rrc, Rrc, Rrc, Rrc, Xoym, Brym, Brym, Brym, Brym, Brym, Rrc, Xoym, Xu, Xu, Xu, Xu, Xu, Xu, Xu, Xu, Xu, Xu, Xu
Xoym, Xoym, Xu, Xoym, Xoym, Xoym, Xoym, Xoym, Xu, Xoym, Xoym, Rrc, Rrc, Rrc, Rr, Xoym, Xu, Xu, Uu, Xu, Xu, Xu, Xu, Xu, Xu, Xu, Xu
Xu, Xu, Xu, Xu, Xu, Xu, Xu, Xu, Xu, Xu, Xu, Rr, Rr, Rr, Ur, Uu^Bryl, Xu, Xu, Ur, Uu, Uu, Uu^Vu, Uu, Xu, Uu, Xu, Xu
Xu, Xu, Xu, Xu, Xu, Xu, Xu, Xu, Xu, Xu, Xu, Uu^Bryl, Ur, Ur, Ur, Ur, Ur, Ur^Pr\, Xu, Ur, Ur, Uu, Ur, Uu, Uu, Xu, Xu
Xu, Xu, Xu, Xu, Uu, Xu, Uu, Uu^Vu, Uu, Xu, Ur^Pr\, Ur, Xu, Uu, Uu, Ur, Uu, Xu, Xu, Xu, Uu, Ur, Ur, Ur, Uu, Xu, Xu
Xu, Xu, Xu, Xu, Uu, Uu, Ur, Ur, Ur, Ur, Uu, Xu, Xu, Xu, Uu, Ur, Uu, Uu, Xu, Xu, Uu, Ur, Ur, Ur, Uu, Xu, Xu
Xu, Xu, Xu, Xu, Uu, Ur, Ur, Ur, Ur, Ur, Uu, Xu, Xu, Xu, Xu, Ur, Ur, Uu, Xu, Xu, Uu, Uu, Ur, Ur, Uu, Uu, Xu
Xu, Xu, Xu, Xu, Uu, Uu, Uu, Ur, Uu, Ur, Uu, Uu, Xu, Xu, Uu, Uu, 3 Ur, Uu, Uu^Vu, Xu, Xu, Uu, Uu, Ur, Uu, Xu, Xu
Xu, Xu, Xu, Xu, Xu, Xu, Xu, Uu, Xu, Uu, Uu, Xu, Xu, Xu, Uu, Ur, Ur, Ur, Uu, Xu, Xu, Uu, Uu, Uu, Uu, Xu, Xu
Xu, Xu, Xu, Xu, Ms^Xm, Xu, Xu, Xu, Xu, Xu, Xu, Xu, Xu, Xu, Uu, Ur, Ur, Ur, Uu, Uu, Xu, Xu, Xu, Uu, Xu, Xu, Xu
Ms^Xm, Xu, Ms^Xm, Ms^Xm, Ms^Xm, Ms^Xm, Ms^Xm, Ms^Xm, Ms^Xm, Xu, Xu, Xu, Xu, Xu, Uu, Uu, Ur, Uu, Uu, Uu, Xu, Xu, Xu, Xu, Xu, Xu, Ms^Xm
Ms^Xm, Ms^Xm, Ms^Xm, Ms^Xm, Ms^Xm, Ms^Xm, Ms^Xm, Ms^Xm, Ms^Xm, Xu, Xu, Xu, Xu, Xu, Rr, Uu, Rr, Uu, Rr, Uu, Xu, Xu, Xu, Xu, Ms^Xm, Ms^Xm, Ms^Xm
Ms^Xm, Ms^Xm, Ms^Xm, Ms^Xm, Ms^Xm, Ms^Xm, Ms^Xm, Ms^Xm, Ms^Xm, Ms^Xm, Ms^Xm, Xu, Rr, Rr, Rr, Rr, Rr, Rr, Rr, Rr, Rr, Xu, Xu, Ms^Xm, Ms^Xm, Ms^Xm, Ms^Xm
Ms^Xm, Ms^Xm, Ms^Xm, Ms^Xm, Ms^Xm, Ms^Xm, Ms^Xm, Ms^Xm, Ms^Xm, Ms^Xm, Ms^Xm, Ms^Xm, Rr, Rr, 5 Cay, Rr, Rr, Rr, 2 Cay, Rr, Rr, Rr, Rr, Ms^Xm, Ms^Xm, Ms^Xm, Ms^Xm
Ms^Xm, Ms^Xm, Ms^Xm, Ms^Xm, Ms^Xm, Ms^Xm, Ms^Xm, Ms^Xm, Ms^Xm, Ms^Xm, Ms^Xm, Rr, Rr, Rr, Rr, Rr, Rr, Rr, Rr, Rr, Rr, Rr, Ms^Xm, Ms^Xm, Ms^Xm, Ms^Xm, Ms^Xm
Ms^Xm, Ms^Xm, Ms^Xm, Ms^Xm, Ms^Xm, Ms^Xm, Ms^Xm, Ms^Xm, Ms^Xm, Ms^Xm, Ms^Xm, Rr, Rr, Rr, Rr, Rr, Rr, Rr, Rr, Rr, Rr, Rr, Ms^Xm, Ms^Xm, Ms^Xm, Ms^Xm, Ms^Xm
