Qxu, Qxu, Qxu, Qxu, Qxu, Qxu, Qxu, Qxu, Qxu, Qxu, Qxu, Qxu, Qxu, Qxu, Qxu, Qxu, Qxu, Qxu, Qxu, Qxu, Qxu, Qxu, Qxu, Qxu, Qxu, Qxu, Qxu
Qxu, Qxu, Qxu, Qxu, Qxu, Qxu, Qxu, Qxu, Qxu, Qxu, Qxu, Qxu, Qxu, Qxu, Qxu, Qxu, Qxu, Qxu, Qxu, Qxu, Qxu, Qxu, Qxu, Qxu, Qxu, Qxu, Qxu
Qxu, Qxu, Qxu, Qxu, Qxu, Qxu, Qxu, Qxu, Qxu, Qxu, Qxu, Qxu, Qxu, Qxu, Qxu, Qxu, Qxu, Qxu, Qxu, Qxu, Qxu, Qxu, Qxu, Qxu, Qxu, Qxu, Qxu
Qxu, Qxu, Qxu, Qxu, Qxu, Qxu, Qxu, Qxu, Qxu, Qxu, Qxu, Qxu, Qxu, Qxu, Qxu, Qxu, Qxu, Qxu, Qxu, Qxu, Qxu, Qxu, Qxu, Qxu, Qxu, Qxu, Qxu
Qxu, Qxu, Qxu, Qxu, Qxu, Qxu, Qxu, Qxu, Qxu, Qxu, Qxu, Qxu, Qxu, Qxu, Qxu, Qxu, Qxu, Qxu, Qxu, Qxu, Qxu, Qxu, Qxu, Qxu, Qxu, Qxu, Qxu
Qxu, Qxu, Qxu, Qxu, Qxu, Qxu, Qxu, Qxu, Uh, Qxu, Qxu, Qxu, Qxu, Qxu, Qxu, Qxu, Qxu, Qxu, Qxu, Qxu, Qxu, Qxu, Qxu, Qxu, Qxu, Qxu, Qxu
Qxu, Qxu, Qxu, Qxu, Qxu, Qxu, Uh, Uh, Cmy, Cmy, Cmy, Uh, Uh, Qxu, Uu, Qxu, Qxu, Qxu, Qxu, Qxu, Qxu, Qxu, Qxu, Qxu, Qxu, Qxu, Qxu
Qxu, Qxu, Qxu, Qxu, Qxu, Qxu, Uh, Uu, Cmy, 4 Kmy, Cmy, Rrc, Rrc, Uu, Uu, Uu, Cmy, Qxu, Qxu, Qxu, Qxu, Qxu, Qxu, Qxu, Qxu, Qxu, Qxu
Qxu, Qxu, Qxu, Qxu, Qxu, Qxu, Uu, Uu, Rrc, Cmy, Rrc, Ymnv, Rrc, Uu, Uu, Uu, Uu, Qxu, Qxu, Qxu, Qxu, Qxu, Qxu, Qxu, Qxu, Qxu, Qxu
Qxu, Qxu, Qxu, Qxu, Qxu, Uh, Uu, Rr, Rrc, Rrc, Rr, Rrc, Uu, Uu, Uu, Uu, Uu, Qxu, Qxu, Qxu, Qxu, Qxu, Qxu, Qxu, Qxu, Qxu, Qxu
Qxu, Qxu, Qxu, Qxu, Qxu, Uh, Uu, Rr, Rr, Rrc, Uu, Uu, Uu, Uu, Uu, Uu, Uu, Uu, Qxu, Qxu, Qxu, Qxu, Qxu, Qxu, Qxu, Qxu, Xu
Qxu, Qxu, Qxu, Qxu, Qxu, Uh, Uu, Uu, Uu, Rr, Uu, Uu, Uu, Uu, Uu, Uu, Uh, Uu, Uu, Qxu, Qxu, Qxu, Uu, Qxu, Rb, Xu, Xu
Xu, Qxu, Uh, Qxu, Uh, Uh, Uu, Uu, Uu, Rr, Rr, Uu, Uu, Uu, Uu, Uu, Ql, Uh, Uh, Uu, Uh, Uh, Uu, Rb, Uu, Xu, Xu
Xu, Xu, Uu, Uh, Ql, Uu, Uu, Uu, Uu, Uu, Uu, Rr, Uu, Uu, Uu, Uu, Uu, Uh, Uh, Uh, Ql, Uh, Uu, Uu^Vu, Uu, Xu, Xu
Xu, Xu, Uu, Ql, Uu, Uu, Uu, Uu, Uu, Uu, Uu, Rr, Rr, Uu, Uu, Uu, Uu, Ql, Uu, Uh, Uu, Uu, Rb, Rb, Uu, Xu, Xu
Xu, Xu, Uu, Rb, Rb, Uu^Vu, Uu, Uu, Uu, Uu, Uu, Rr, Rr, Uu, Uu, Uu, Uu, Uu, Rb, Uu, Rb, Rb, Xyom, Uu, Xyom, Xyom, Xyom
Xyom, Xyom, Uu, Uu, Uu, Rb, Rb, Uu, Uu, Uu, Rr, Rr, Rr, Rr, Rr, Uu, Rb, Rb, Uu, Rb, Xyom, Xyom, Xyom, Xyom, Xyom, Xyom, Xyom
Xyom, Xyom, Xyom, Uu, Uu, Uu, Uu, Rb, Uu, Rr, Uu, Rr, Rr, Uu, Uu, Rb, Xyom, Xyom, Xyom, Xyom, Xyom, Xyom, Xyom, Xyom, Xyom, Xyom, Xyom
Xyom, Xyom, Xyom, Xyom, Xyom, Xyom, Xyom, Uu, Xyom, Uu, Uu, Rr, Cmy, Rr, Xyom, Xyom, Xyom, Xyom, Rrc, Xyom, Rrc, Rrc, Rrc, Rrc, Xyom, Xyom, Xyom
Xyom, Xyom, Brym, Brym, Brym, Xyom, Xyom, Xyom, Xyom, Xyom, Xyom, Brym, Brym, Brym, Brym, Xyom, Rrc, Rrc, Rrc, Rrc, Rrc, Rrc, Rrc, Rrc, Xyom, Xyom, Xyom
Xyom, Xyom, Brym, Brym^Vymb, Brym, Brym, Xyom, Xyom, Rrc, Xyom, Brym, Brym, Brym, Brym, Brym^Bryl, Brym, Rrc, Xyom, Xyom, Rrc, Xyom, Rrc, Xyom, Xyom, Xyom, Xyom, Xyom
Xyom, Xyom, Rrc, Brym, Rrc, Rrc, Rrc, Rrc, Rrc, Rrc, Xyom, Xyom, Brym, Brym, Brym, Brym, Brym, Rrc, Xyom, Xyom, Xyom, Xyom, Xyom, Xyom, Xyom, Xyom, Xyom
Xyom, Xyom, Rrc, Rrc, Rrc, Rrc, Rrc, Rrc, Rrc, Xyom, Xyom, Brym, Brym, Brym, Xyom, Brym, Xyom, Xyom, Xyom, Xyom, Xyom, Xyom, Xyom, Xyom, Xyom, Xyom, Xyom
Xyom, Xyom, Rrc, Rrc, Rrc, Rrc, Xyom, Xyom, Xyom, Xyom, Brym, Xyom, Brym, Xyom, Brym, Brym, Brym, Brym, Brym, Xyom, Xyom, Xyom, Xyom, Xyom, Xyom, Xyom, Xyom
Xyom, Xyom, Rrc, Rrc, Xyom, Xyom, Brym, Xyom, Brym, Brym, Brym, Brym, Brym, Brym, Brym, Brym, Brym, Brym^Vymb, Brym, Brym, Xyom, Xyom, Brym, Xyom, Xyom, Xyom, Xyom
Xyom, Xyom, Xyom, Xyom, Xyom, Xyom, Brym, Brym, Brym, Brym, Brym, Brym, Brym, Brym, Brym, Brym, Brym, Brym, Brym, Brym, Xyom, Brym, Brym, Brym, Brym, Xyom, Xyom
Xyom, Xyom, Xyom, Xyom, Brym, Xyom, Brym, Brym, Brym^Lyml, Brym, Brym, Brym, Cmy, Cmy, Cmy, Brym, Brym, Brym, Xyom, Xyom, Brym, Brym, Brym, Brym, Brym, Xyom, Xyom
Xyom, Xyom, Xyom, Brym, Brym, Brym, Brym, Xyom, Rrc^Lymp, Brym^Lyml, Brym, Brym, Cmy, 1 Kmy, Cmy, Brym, Brym, Brym, Brym, Xyom, Brym, Brym, Brym, Brym, Brym, Xyom, Xyom
Xyom, Xyom, Xyom, Brym, Brym, Brym, Brym, Xyom, Brym^Lyml, Brym^Lyml, Brym, Brym, Brym, Cmy, Brym, Brym, Brym, Brym, Brym, Brym, Xyom, Xyom, Brym, Brym, Xyom, Xyom, Xyom
Xyom, Xyom, Xyom, Brym, Brym, Brym, Xyom, Xyom, Brym, Brym, Brym^Vymb, Brym, Brym, Brym, Brym, Brym, Brym, Brym, Brym, Xyom, Xyom, Brym, Brym, Brym, Xyom, Xyom, Xyom
Xyom, Xyom, Xyom, Brym, Xyom, Xyom, Brym, Brym, Brym, Brym, Brym, Brym, Brym, Brym, Brym, Brym, Xomy, Brym, Brym, Xyom, Xyom, Brym, Xyom, Xyom, Rr, Xyom, Xyom
Xyom, Xyom, Xyom, Xyom, Brym, Brym, Brym, Brym, Brym, Brym, Xomy, Brym, Brym^Bryl, Brym, Brym^Bryl, Brym, Brym, Xomy, Brym, Brym, Rrc, Xyom, Xyom, Rr, Rr, Rr, Xyom
Xyom, Xyom, Xyom, Xyom, Brym, Brym, Brym^Vymb, Brym, Brym, Xomy, Brym, Brym, Brym, Brym, Brym, Brym, Brym, Brym, Rrc, Rrc, Rrc^Gye, Xyom, Xyom, Rr, Rr, Rr, Xyom
Xyom, Xyom, Xyom, Xyom, Brym, Brym, Brym, Brym, Brym, Brym, Brym, Brym, Brym, Brym, Brym, Brym, Rrc, Rrc, Rrc^Gye, Rrc^Gye, Rd, Rd, Rr, Rr, Xyom, Xyom, Xu
Xyom, Xyom, Xyom, Xyom, Brym, Brym, Brym, Brym, Brym, Brym, Brym, Brym, Xyom, Brym, Xyom, Xyom, Xyom, Rrc^Gye, Rd, Rd, Ds, Ds, Ds, Rr, Rr, Xyom, Xu
Xyom, Xyom, Xyom, Xyom, Xyom, Brym, Brym, Brym, Xyom, Brym, Xyom, Xyom, Xyom, Xyom, Xyom, Xyom, Rr, Rd, Ds, Ds, Dd, Ds, Ds, Rr, Xyom, Xyom, Xu
Xyom, Xyom, Xyom, Xyom, Xyom, Xyom, Xyom, Xyom, Xyom, Xyom, Xyom, Xyom, Xyom, Xyom, Xyom, Xyom, Rr, Rd, Ds, Ds, Ds, Ds^Dr, Ds, Rr, Xyom, Xu, Xu
Xyom, Xyom, Xyom, Xyom, Urfz, Xyom, Xyom, Xyom, Xyom, Xyom, Xyom, Xyom, Rr, Xyom, Rr, Rr, Dd^Dr, Ds, Dd, Dd, Ds, Ds, Ds, Rr, Xyom, Xu, Xu
Xyom, Xyom, Urfz, Urfz, Urfz, Urfz, Urfz, Xyom, Xyom, Xyom, Rr, Rr, Rd, Rr, Ds, Ds, Dd, Dd, Dd, Dd, Dd, Dd, Ds, Rr, Rr, Xyom, Xu
Xyom, Urfz, Urfz, Urfz, Urfz, Urfz, Xyom, Xyom, Rr, Rr, Rd, Rd, Ds, Ds, Ds, Ds, Dd, Ds, Dd, Dd, Dd, Ds, Ds, Ds, Rr, Xyom, Xu
Xyom, Xyom, Rrc, Urfz, Xyom, Xyom, Xyom, Xyom, Rr, Rr, Rd, Rd, Rd^Qov, Ds, Ds, Ds, Ds, Ds, Dd, Dd, Dd, Dd, Ds, Ds, Rr, Xyom, Xu
Xyom, Xyom, Rrc^Gye, Xyom, Brym, Xyom, Xyom, Xyom, Rrc, Rr, Rrc, Rd, Ds, Ds, Ds, Ds, Ds, Ds^Dr, Dd, Dd, Ds, Ds, Ds, Ds, Rd, Xyom, Xu
Xyom, Xyom, Xyom, Brym, Brym^Vymb, Brym, Rrc, Rrc^Gyw, Rrc^Gyw, Rrc, Rrc, Rrc, Ds, Ds, Dd, Dd, Dd, Ds, Ds, Ds, Ds, Ds^Dr, Ds, Ds, Rd, Xyom, Xu
Xyom, Xyom, Xyom, Brym, Brym, Brym, Brym, Rrc, Rrc, Rrc^Gyw, Xyom, Rrc, Rrc, Ds, Ds, Dd, Ds, Ds, Ds, Ds, Ds, Ds, Rd^Vu, Rd, Xyom, Xyom, Xu
Xyom, Xyom, Xyom, Rrc, Brym, Brym, Rrc, Rrc, Xyom, Xyom, Rr, Rr, Rd^Qov, Ds, Ds^Dr, Ds, Ds, Ds, Rr, Rd, Rd, Rd, Rd, Rd, Xyom, Xu, Xos
Xyom, Xyom, Xyom, Rrc, Brym, Brym, Rrc, Xyom, Xyom, Xyom, Xyom, Rr, Rd, Ds, Ds, Ds, Rr, Rr, Xyom, Rr, Xyom, Xyom, Xyom, Xyom, Xos, Xos, Xos
Xyom, Xyom, Rrc^Bryl, Rrc, Brym, Brym, Brym, Xyom, Xyom, Xyom, Xyom, Rr, Ds, Ds, Rr, Rd, Xyom, Xyom, Xyom, Xyom, Xos, Xos, Xos, Xos, Xos, Xos, Xos
Xyom, Xyom, Xyom, Rrc, Brym, Brym, Brym, Brym^Vymb, Xyom, Xyom, Xyom, Rr, Rr, Rd, Xyom, Xyom, Xos, Xos, Xos, Xos, Xos, Xos, Xos, Xos, Brym^Vymb, Xos, Xos
Xyom, Xyom, Xyom, Rrc, Brym, Brym, Brym, Brym, Xyom, Xyom, Xyom, Rr, Xyom, Xyom, Xos, Xyom, Xos, Xos, Xos, Xos, Urfz, Xos, Urfz, Brym, Brym, Xos, Xos
Xyom, Xyom, Rrc^Bryl, Rrc, Brym, Brym, Rrc, Xyom, Xyom, Xyom, Xyom, Xyom, Xos, Xos, Xos, Xos, Urfz, Xos, Urfz, Urfz, Urfz, Urfz, Urfz, Urfz, Urfz, Xos, Xos
Xyom, Xyom, Xyom, Rrc, Brym, Brym, Rrc, Xyom, Xyom, Xyom, Xyom, Xyom, Xyom, Xos, Xos, Urfz, Urfz, Urfz, Urfz, Urfz, Urfz, Urfz, Urfz, Urfz, Urfz, Xos, Xos
Xyom, Xyom, Xyom, Rrc, Brym, Brym, Cmy, Rrc, Xyom, Xyom, Xyom, Xyom, Xyom, Xyom, Xyom, Xos, Rrc^Gyw, Urfz, Urfz, Urfz, Urfz, Urfz, Urfz, Urfz, Urfz, Xos, Xos
Xyom, Xyom, Xyom, Rrc, Brym, 6 Kmy, Cmy, Brym, Brym, Rrc, Rrc, Rrc, Rrc, Xyom, Brym, Rrc, Brym, Xos, Xos, Urfz, Xos, Urfz, Urfz, Urfz, Urfz, Xos, Xos
Xyom, Xyom, Xyom, Rrc, Xyom, Brym, Brym, Cmy, Brym, Brym, Brym, Rrc, Brym, Brym, Brym, Brym, Xyom, Xos, Xos, Xos, Xos, Xos, Urfz, Urfz, Urfz, Xos, Xos
Xyom, Xyom, Xyom, Xyom, Rrc, Rrc, Rrc, Brym, Brym, Brym, Brym^Fynt, Brym, Brym, Brym, Brym, Brym, Xyom, Xyom, Xyom, Xos, Xos, Xos, Urfz, Urfz, Urfz, Xos, Xos
Xyom, Xyom, Xyom, Xyom, Rrc, Rrc, Rrc, Rrc, Rrc, Brym, Brym, Brym, Brym^Bryl, Brym, Brym, Xyom, Xu, Xyom, Xu, Xu, Xu, Xos, Xos, Xos, Xos, Xos, Xos
Xyom, Xyom, Xyom, Xyom, Rrc, Rrc, Rrc, Rrc, Xyom, Brym, Brym, Brym, Brym, Brym, Rrc, Xyom, Xu, Xu, Xu, Xu, Xu, Xu, Xu, Xu, Xu, Xu, Xu
Xyom, Xyom, Xu, Xyom, Xyom, Xyom, Xyom, Xyom, Xu, Xyom, Xyom, Rrc, Rrc, Rrc, Rr, Xyom, Xu, Xu, Uu, Xu, Xu, Xu, Xu, Xu, Xu, Xu, Xu
Xu, Xu, Xu, Xu, Xu, Xu, Xu, Xu, Xu, Xu, Xu, Rr, Rr, Rr, Ur, Uu^Bryl, Xu, Xu, Ur, Uu, Uu, Uu^Vu, Uu, Xu, Uu, Xu, Xu
Xu, Xu, Xu, Xu, Xu, Xu, Xu, Xu, Xu, Xu, Xu, Uu^Bryl, Ur, Ur, Ur, Ur, Ur, Ur^Gyw, Xu, Ur, Ur, Uu, Ur, Uu, Uu, Xu, Xu
Xu, Xu, Xu, Xu, Uu, Xu, Uu, Uu^Vu, Uu, Xu, Ur^Gyw, Ur, Xu, Uu, Uu, Ur, Uu, Xu, Xu, Xu, Uu, Ur, Ur, Ur, Uu, Xu, Xu
Xu, Xu, Xu, Xu, Uu, Uu, Ur, Ur, Ur, Ur, Uu, Xu, Xu, Xu, Uu, Ur, Uu, Uu, Xu, Xu, Uu, Ur, Ur, Ur, Uu, Xu, Xu
Xu, Xu, Xu, Xu, Uu, Ur, Ur, Ur, Ur, Ur, Uu, Xu, Xu, Xu, Xu, Ur, Ur, Uu, Xu, Xu, Uu, Uu, Ur, Ur, Uu, Uu, Xu
Xu, Xu, Xu, Xu, Uu, Uu, Uu, Ur, Uu, Ur, Uu, Uu, Xu, Xu, Uu, Uu, 3 Ur, Uu, Uu^Vu, Xu, Xu, Uu, Uu, Ur, Uu, Xu, Xu
Xu, Xu, Xu, Xu, Xu, Xu, Xu, Uu, Xu, Uu, Uu, Xu, Xu, Xu, Uu, Ur, Ur, Ur, Uu, Xu, Xu, Uu, Uu, Uu, Uu, Xu, Xu
Xu, Xu, Xu, Xu, Ms^Xm, Xu, Xu, Xu, Xu, Xu, Xu, Xu, Xu, Xu, Uu, Ur, Ur, Ur, Uu, Uu, Xu, Xu, Xu, Uu, Xu, Xu, Xu
Ms^Xm, Xu, Ms^Xm, Ms^Xm, Ms^Xm, Ms^Xm, Ms^Xm, Ms^Xm, Ms^Xm, Xu, Xu, Xu, Xu, Xu, Uu, Uu, Ur, Uu, Uu, Uu, Xu, Xu, Xu, Xu, Xu, Xu, Ms^Xm
Ms^Xm, Ms^Xm, Ms^Xm, Ms^Xm, Ms^Xm, Ms^Xm, Ms^Xm, Ms^Xm, Ms^Xm, Xu, Xu, Xu, Xu, Xu, Rr, Uu, Rr, Uu, Rr, Uu, Xu, Xu, Xu, Xu, Ms^Xm, Ms^Xm, Ms^Xm
Ms^Xm, Ms^Xm, Ms^Xm, Ms^Xm, Ms^Xm, Ms^Xm, Ms^Xm, Ms^Xm, Ms^Xm, Ms^Xm, Ms^Xm, Xu, Rr, Rr, Rr, Rr, Rr, Rr, Rr, Rr, Rr, Xu, Xu, Ms^Xm, Ms^Xm, Ms^Xm, Ms^Xm
Ms^Xm, Ms^Xm, Ms^Xm, Ms^Xm, Ms^Xm, Ms^Xm, Ms^Xm, Ms^Xm, Ms^Xm, Ms^Xm, Ms^Xm, Ms^Xm, Rr, Rr, 5 Cay, Rr, Rr, Rr, 2 Cay, Rr, Rr, Rr, Rr, Ms^Xm, Ms^Xm, Ms^Xm, Ms^Xm
Ms^Xm, Ms^Xm, Ms^Xm, Ms^Xm, Ms^Xm, Ms^Xm, Ms^Xm, Ms^Xm, Ms^Xm, Ms^Xm, Ms^Xm, Rr, Rr, Rr, Rr, Rr, Rr, Rr, Rr, Rr, Rr, Rr, Ms^Xm, Ms^Xm, Ms^Xm, Ms^Xm, Ms^Xm
Ms^Xm, Ms^Xm, Ms^Xm, Ms^Xm, Ms^Xm, Ms^Xm, Ms^Xm, Ms^Xm, Ms^Xm, Ms^Xm, Ms^Xm, Rr, Rr, Rr, Rr, Rr, Rr, Rr, Rr, Rr, Rr, Rr, Ms^Xm, Ms^Xm, Ms^Xm, Ms^Xm, Ms^Xm
