border_size=1
usage=map

Gg          , Gg          , Gg          , Gg          , Gs^Ft       , Gs^Ft       , Gs^Ft       , Gs^Ft       , Gs^Ft       , Gg          , Gg          , Hd          , Hd          , Hd          , Hd          , Hd          , Hd          
Gg          , Gg          , Gg          , Gg          , Gs^Ft       , Gs^Ft       , Gs^Ft       , Gs^Ft       , Gs^Ft       , Gg          , Gg          , Hd          , Hd          , Hd          , Hd          , 1 Hd        , Hd          
Gg          , Gg          , Gs^Ft       , Gs^Ft       , Gs^Ft       , Gs^Ft       , Gs^Ft       , Gs^Ft       , Gs^Ft       , Gg          , Gg          , Gg          , Gg          , Hd          , Hd          , Hd          , Ds          
Gg          , Gs^Ft       , Gs^Ft       , Gs^Ft       , Gs^Ft       , Gs^Ft       , Gs^Ft       , Gs^Ft       , Gs^Ft       , Gg          , Gg          , Ds          , Ds          , Ds          , Ds          , Ds          , Ww          
Gg          , Gs^Ft       , Gs^Ft       , Gs^Ft       , Gs^Ft       , Gs^Ft       , Gs^Ft       , Gs^Ft       , Gg          , Gg          , Ds          , Ds          , Ds          , Ds          , Ww          , Ww          , Ww          
Rd          , Gs^Ft       , Gs^Ft       , Gs^Ft       , Gs^Ft       , Gs^Ft       , Gs^Ft       , Gs^Ft       , Gg          , Gg          , Ds          , Ds          , Wo          , Ww          , Ww          , Ww          , Ww          
Gg          , Rd          , Rd          , Gs^Ft       , Gs^Ft       , Gs^Ft       , Gs^Ft       , Gs^Ft       , Gs^Ft       , Gg          , Ds          , Wo          , Wo          , Ww          , Ww          , Ww          , Ds          
Gs^Ft       , Gs^Ft       , Rd          , Gs^Ft       , Gs^Ft       , Gs^Ft       , Gs^Ft       , Gs^Ft       , Gs^Ft       , Gg          , Gg          , Wo          , Wo          , Wwr         , Wwr         , Ds          , Ds          
Gs^Ft       , Gg          , Rd          , Gs^Ft       , Gs^Ft       , Gs^Ft       , Gs^Ft       , Gs^Ft       , Gs^Ft       , Gg          , Gg          , Wo          , Wo          , Wwr         , Wwr         , Ds          , Ds          
Gs^Ft       , Gg          , Rd          , Gg          , Gg          , Gs^Ft       , Gs^Ft       , Gs^Ft       , Gg          , Gg          , Gg          , Ds          , Wo          , Wwr         , Ds          , Ds          , Gg          
Gs^Ft       , Gs^Ft       , Rd          , Gs^Ft       , Gg          , Gs^Ft       , Gg          , Gs^Ft       , Gg          , Gg          , Gg          , Ds          , Ww          , Ww          , Ds          , Ds          , Gg          
Gs^Ft       , Gg          , Rd          , Gg          , Gs^Ft       , Gg          , Ds          , Gg          , Gg          , Gg          , Gg          , Ds          , Ww          , Ww          , Ds          , Ds          , Gg          
Gg          , Gs^Ft       , Rd          , Gg          , Gs^Ft       , Gs^Ft       , Ds          , Gg          , Gg          , Gg          , Ds          , Ds          , Ww          , Ww          , Ds          , Ds          , Gg          
Gg          , Gg          , Gs^Vht      , Rd          , Rd          , Ds          , Ds          , Ds          , Ds          , Ds          , Ww          , Ww          , Ww          , Ww          , Ds          , Gg          , Gg          
Gg          , Gg          , Ds          , Ds          , Ds          , Ww^Bw\      , Ww^Bw\      , Ds          , Ww          , Ww          , Wo          , Wo          , Ds          , Ds          , Gg          , Gg          , Ds          
Gg          , Gs^Ft       , Ds          , Ds          , Ww          , Ww          , Ww          , Ww          , Ww          , Ww          , Ds          , Ds          , Ds          , Ds          , Gg          , Ds          , Ds          
Gg          , Gg          , Ds          , Ww          , Ww          , Ww          , Wo          , Ww          , Ds          , Ds          , Gs^Ft       , Gs^Ft       , Gs^Ft       , Gg          , Gg          , Ds          , Ds          
Gg          , Gg          , Gg          , Ds          , Ds          , Ww          , Ww          , Ds          , Ds          , Gs^Ft       , Gs^Ft       , Gs^Ft       , Gs^Ft       , Gg          , Ds          , Ds          , Ds          
Gg          , Gg          , Gg          , Gs^Vht      , Ds          , Ww          , Ww          , Ww          , Ww          , Ds          , Gs^Ft       , Gs^Ft       , Gg          , Gg          , Ds          , Ds          , Ds          
Gg          , Gg          , Gg          , Gg          , Ds          , Ds          , Ww          , Ww          , Ww          , Ds          , Ds          , Gs^Vht      , Gg          , Ds          , Ds          , Ds          , Ds          
Gg          , Gg          , Gs^Ft       , Gs^Ft       , Gg          , Ds          , Ds          , Ww          , Ww          , Ww          , Ww          , Ds          , Gg          , Ds          , Ds          , Ds          , Ds          
Gg          , Gg          , Gg          , Gg          , Gg          , Gg          , Ds          , Ww          , Ww          , Ww          , Ww          , Ds          , Ds          , Ds          , Ds          , Ds          , Ds          
Ds          , Ds          , Ds          , Ds          , Ds          , Ds          , Ds          , Ds          , Wwr         , Ww          , Ww          , Ds          , Ds          , Ds          , Ds          , Ds          , Ww          
Ds          , Ds          , Ds          , Ds          , Ds          , Ds          , Ds          , Ds          , Ww          , Ww          , Ww          , Ww          , Ww          , Ww          , Ww          , Ww          , Ww          
Ww          , Ww          , Ww          , Ww          , Ww          , Ww          , Wwr         , Ww          , Wwr         , Ww          , Wwr         , Wo          , Wo          , Ww          , Ww          , Ww          , Ww          
Wo          , Wwr         , Wwr         , Wwr         , Wwr         , Wwr         , Wo          , Wo          , Wo          , Wo          , Wo          , Wo          , Ww          , Ww          , Ww          , Ww          , Ww          
Wo          , Wo          , Wo          , Wwr         , Wo          , Wo          , Wo          , Wo          , Wo          , Wo          , Wo          , Wo          , Wo          , Wo          , Wo          , Wo          , Wo          
