Xom, Xom, Xom, Xom, Xom, Xom, Xom, Xom, Xom, Xom, Xoi, Xom, Xom, Xom
Xom, Xom, Xom, Xom, Xom, Xom, Xom, Xom, Xoi, Xoi, Iwr, Xoi, Xoi, Xom
Xom, Xom, Xom, Xom, Xom, Ce^Bryl, Ce, Ce^Bryl, Xom, Iwr, Iwr^Taby, Iwr, Iwr, Xom
Xom, Xom, Xom, Xom, Xom, Ce^Xo, Iwr^Taby, Ce^Xo, Xom, Iwr, Iwr, Iwr, Iwr, Xom
Xom, Xom, Iwr, Iwr^Xo, Xom, Iwr, Iwr, Iwr, Iwr, Iwr, Xoi, Iwr, Xoi, Xom
Xom, Iwr, Iwr^Taby, Iwr^Taby, Iwr, Xom, Rp, Iwr, Iwr, Iwr, Iwr, Xoi, Xom, Xom
Xom, Xom, Xom, Iwr, Rp, Rp, Rp, Iwr^Taby, Rp, Iwr, Rp, Iwr^Taby, Xom, Xom
Xom, Xom, Xom, Xom, Re^Es, Rp, Rp, Rp, Rp, Rp, Iwr, Iwr, Xom, Xom
Xom, Xom, Xom, Re, Re, Re, Ce, Re, Re, Re, Re, Iwr, Xom, Xom
Xom, Xom, Xom, Xom, Iwr, Ce, 1 Ke, Ce, Iwr, Re, Xom, Xom, Xom, Xom
Xom, Xom, Xom, Xom, Re, Ce, Ce, Ce, Re, Xom, Xom, Xom, Xom, Xom
Xom, Xom, Xom, Xom, Re, Re, Rb, Re^Es, Gd, Xom, Xom, Xom, Xom, Xom
Xom, Xom, Xom, Xom, Gd, Rp, Rp, Rp, Gg, Xom, Xom, Xom, Xom, Xom
Xom, Xom, Xom, Xom, Xom, Rp, Gg, Gg, Gg, Xom, Xom, Xom, Xom, Xom
