Xos, Xos, Xos, Xos, Xos, Xos, Xos, Xos, Xos, Xos, Xos, Xos, Xos, Xos, Xos, Xos, Xos
Xos, Xos, Iwr, Xos, Xos, Xos, Xos, Xos, Xos, Xos, Iwr, Xos, Xos, Xos, Xos, Xos, Xos
Xos, Iwr, Iwr, Iwr, Xos, Ce^Bryl, Ce, Ce^Bryl, Xos, Iwr, Iwr^Taby, Iwr, Iwr, Xos, Xos, Xos, Xos
Xos, Iwr, Iwr, Iwr, Xos, Ce^Xo, Iwr^Taby, Ce^Xo, Xos, Iwr^Taby, Iwr, Iwr, Iwr, Iwr, Iwr, Xos, Xos
Xos, Xos, Iwr^Pwd, Xos, Xos, Iwr, Iwr, Iwr, Iwr, Iwr, Iwr, Iwr^Taby, Iwr, Iwr, Xos, Xos, Xos
Xos, Xos, Iwr, Xos, Iwr, Iwr, Re, Iwr, Iwr, Iwr^Taby, Iwr, Iwr, Xos, Xos, Xos, Xos, Xos
Xos, Xos, Xos, Iwr, Re, Re, Re, Iwr^Taby, Re, Iwr, Re, Iwr^Taby, Xos, Xos, Xol, Xos, Xos
Xos, Xos, Xos, Xos, Re, Re, Re, Re, Xos, Re, Xos, Iwr^Pwd, Ior, Ior, Ior, Xol, Xos
Xos, Xos, Xos, Re, Re, Re, Ce, Re, Re, Xos, Xos, Ior, Urb, Urb, Urb, Ior, Xos
Xos, Xos, Xos, Xos, Iwr, Ce, 1 Ke, Ce, Iwr, Re, Xos, Xos, Uu, Uu, Uu, Xos, Xos
Xos, Xos, Xos, Xos, Re, Ce, Ce, Ce, Re, Xos, Xos, Xos, Uu, Ql, Uu, Xos, Xos
Xos, Xos, Xos, Xos, Re, Re, Rb, Re, Rb, Xos, Xos, Xos, Xos, Uu, Xos, Xos, Xos
Xos, Xos, Xos, Xos, Rb, Rb, Rb, Rb, Aa, Xos, Xos, Xos, Xos, Xos, Xos, Xos, Xos
Xos, Xos, Xos, Xos, Xos, Aa, Aa, Aa, Aa, Xos, Xos, Xos, Xos, Xos, Xos, Xos, Xos
